id,out,in,all,bins,unique,,
17776,1,1,2,1,1,475,475
5578,3,19,22,2,2,597,1194
1835,46,76,122,3,3,634,1902
14790,1,8,9,4,4,683,2732
8606,8,41,49,5,5,655,3275
12376,2,0,2,6,6,664,3984
13981,7,23,30,7,7,661,4627
17378,2,4,6,8,8,585,4680
14371,12,1,13,9,9,604,5436
9504,5,1,6,10,10,553,5530
5072,14,4,18,20,11,521,5731
1523,10,58,68,30,12,485,5820
3382,3,5,8,40,13,411,5343
2300,31,51,82,50,14,404,5656
402,3,0,3,100,15,425,6375
3423,19,4,23,200,16,377,6032
11385,9,1,10,300,17,328,5576
6198,2,73,75,400,18,353,6354
2235,31,74,105,500,19,316,6004
11494,14,8,22,600,20,284,5680
3409,4,4,8,700,21,291,6111
8675,1,1,2,800,22,273,6006
8181,22,29,51,,23,230,5290
14890,4,9,13,,24,231,5544
4243,19,4,23,,25,235,5875
8193,5,22,27,,26,209,5434
15647,20,11,31,,27,222,5994
930,26,106,132,,28,202,5656
16323,4,2,6,,29,209,6061
8351,4,0,4,,30,161,4830
13502,2,9,11,,31,180,5580
29,13,6,19,,32,168,5376
10707,5,11,16,,33,141,4653
15871,3,2,5,,34,158,5372
14343,2,1,3,,35,133,4655
1732,38,22,60,,36,109,3924
9185,4,2,6,,37,104,3848
590,2,7,9,,38,114,4332
10421,5,18,23,,39,115,4485
8701,31,19,50,,40,127,5080
3174,10,19,29,,41,118,4838
16339,6,0,6,,42,92,3864
12287,7,0,7,,43,97,4171
15556,1,8,9,,44,96,4224
10189,5,10,15,,45,93,4185
6826,30,3,33,,46,90,4140
17291,5,3,8,,47,85,3995
7511,2,13,15,,48,76,3648
13242,108,6,114,,49,79,3871
3633,3,0,3,,50,80,4000
11175,4,8,12,,51,71,3621
1408,210,12,222,,52,66,3432
16773,2,4,6,,53,72,3816
1443,4,8,12,,54,53,2862
2593,5,3,8,,55,63,3465
1962,42,8,50,,56,60,3360
5653,30,11,41,,57,42,2394
1404,24,6,30,,58,46,2668
6131,8,173,181,,59,56,3304
14311,1,2,3,,60,53,3180
6857,13,15,28,,61,49,2989
3264,146,0,146,,62,53,3286
15227,5,4,9,,63,61,3843
16007,66,8,74,,64,47,3008
7542,24,48,72,,65,41,2665
1010,5,28,33,,66,44,2904
7268,2,1,3,,67,26,1742
8439,5,25,30,,68,50,3400
5994,2,34,36,,69,48,3312
4582,15,2,17,,70,35,2450
7708,9,8,17,,71,39,2769
871,15,8,23,,72,39,2808
2097,4,5,9,,73,30,2190
5778,4,2,6,,74,46,3404
9608,5,2,7,,75,51,3825
7405,16,0,16,,76,31,2356
14121,1,0,1,,77,40,3080
10017,2,2,4,,78,24,1872
6258,2,265,267,,79,33,2607
17428,1,1,2,,80,31,2480
369,15,12,27,,81,34,2754
15866,3,19,22,,82,18,1476
6361,4,1,5,,83,31,2573
15531,7,8,15,,84,26,2184
14510,2,17,19,,85,24,2040
7830,49,22,71,,86,23,1978
10060,4,23,27,,87,26,2262
15231,1,0,1,,88,19,1672
1755,13,13,26,,89,23,2047
12269,2,17,19,,90,21,1890
3126,2,1,3,,91,18,1638
4368,8,68,76,,92,23,2116
531,6,68,74,,93,22,2046
13806,10,8,18,,94,24,2256
10832,28,12,40,,95,21,1995
6318,30,90,120,,96,21,2016
6837,9,19,28,,97,22,2134
12653,7,0,7,,98,28,2744
8322,30,26,56,,99,22,2178
11305,39,1,40,,100,14,1400
15366,10,7,17,,101,24,2424
3095,1,14,15,,102,14,1428
1418,11,11,22,,103,15,1545
17202,25,17,42,,104,20,2080
2848,54,17,71,,105,21,2205
3089,22,7,29,,106,11,1166
5303,7,9,16,,107,14,1498
2603,3,42,45,,108,14,1512
16727,2,9,11,,109,16,1744
16171,5,5,10,,110,15,1650
1684,66,72,138,,111,18,1998
5610,7,4,11,,112,12,1344
7463,15,10,25,,113,15,1695
17562,11,1,12,,114,21,2394
3306,28,196,224,,115,18,2070
11019,12,2,14,,116,8,928
4773,13,15,28,,117,12,1404
5163,10,0,10,,118,8,944
4498,5,3,8,,119,21,2499
14845,5,5,10,,120,14,1680
14892,10,24,34,,121,17,2057
5435,92,114,206,,122,8,976
10382,15,3,18,,123,13,1599
8087,5,7,12,,124,13,1612
12593,2,10,12,,125,9,1125
7991,3,29,32,,126,7,882
14478,4,1,5,,127,21,2667
2247,1,27,28,,128,12,1536
3746,31,12,43,,129,5,645
9381,3,33,36,,130,6,780
2944,15,89,104,,131,9,1179
4362,1,1,2,,132,8,1056
425,12,22,34,,133,4,532
1424,100,20,120,,134,14,1876
11374,3,5,8,,135,7,945
10362,6,3,9,,136,8,1088
3496,16,9,25,,137,8,1096
9233,4,3,7,,138,5,690
9190,7,20,27,,139,8,1112
231,13,6,19,,140,10,1400
2638,4,17,21,,141,4,564
17507,4,0,4,,142,8,1136
12871,1,7,8,,143,4,572
3338,2,6,8,,144,7,1008
12030,4,4,8,,145,9,1305
1982,53,27,80,,146,10,1460
9113,53,8,61,,147,9,1323
1894,219,136,355,,148,5,740
4334,29,23,52,,149,10,1490
7521,48,8,56,,150,2,300
15208,3,34,37,,151,7,1057
6673,107,43,150,,152,3,456
14116,6,6,12,,153,5,765
14017,5,13,18,,154,6,924
2364,42,33,75,,155,4,620
5213,39,12,51,,156,2,312
9742,14,7,21,,157,6,942
12875,1,3,4,,158,5,790
3695,23,64,87,,159,8,1272
15787,5,0,5,,160,8,1280
14558,44,19,63,,161,3,483
13432,13,10,23,,162,7,1134
10326,3,2,5,,163,9,1467
12363,1,21,22,,164,4,656
9789,2,6,8,,165,7,1155
6723,5,12,17,,166,9,1494
609,3,6,9,,167,6,1002
13282,2,2,4,,168,9,1512
427,14,0,14,,169,5,845
17360,2,2,4,,170,3,510
8515,20,8,28,,171,7,1197
10270,11,11,22,,172,7,1204
4450,1,84,85,,173,2,346
15139,20,3,23,,174,4,696
13489,1,2,3,,175,8,1400
4564,50,77,127,,176,5,880
10291,9,19,28,,177,9,1593
12574,16,17,33,,178,7,1246
6295,9,19,28,,179,9,1611
12832,7,18,25,,180,6,1080
1838,9,39,48,,181,13,2353
11228,3,1,4,,182,5,910
4386,1,1,2,,183,8,1464
15502,2,16,18,,184,9,1656
10408,34,28,62,,185,8,1480
8900,1,3,4,,186,7,1302
5084,1,0,1,,187,9,1683
429,4,2,6,,188,4,752
3150,4,35,39,,189,7,1323
14288,2,1,3,,190,6,1140
15413,25,6,31,,191,7,1337
15643,7,1,8,,192,7,1344
16335,5,2,7,,193,5,965
11966,4,5,9,,194,6,1164
11057,1,13,14,,195,4,780
2442,70,61,131,,196,5,980
3000,10,23,33,,197,2,394
14803,5,3,8,,198,3,594
16384,2,2,4,,199,6,1194
11510,20,26,46,,200,3,600
5346,98,73,171,,201,5,1005
11300,12,38,50,,202,4,808
6930,17,5,22,,203,10,2030
10503,49,4,53,,204,6,1224
9893,10,1,11,,205,6,1230
9081,10,41,51,,206,8,1648
9787,6,7,13,,207,12,2484
15433,12,21,33,,208,6,1248
8417,1,7,8,,209,6,1254
1143,7,15,22,,210,7,1470
13215,3,8,11,,211,6,1266
1129,2,9,11,,212,7,1484
13594,8,2,10,,213,4,852
11714,3,74,77,,214,5,1070
16059,40,4,44,,215,4,860
17061,3,8,11,,216,4,864
6419,80,121,201,,217,2,434
11896,52,6,58,,218,4,872
5409,78,99,177,,219,4,876
14948,10,0,10,,220,4,880
3124,94,4,98,,221,7,1547
4922,7,3,10,,222,4,888
1216,5,1,6,,223,2,446
16379,6,4,10,,224,3,672
10955,2,5,7,,225,8,1800
351,3,2,5,,226,2,452
15748,5,2,7,,227,4,908
7229,7,8,15,,228,1,228
6530,11,0,11,,229,3,687
8324,4,23,27,,231,4,924
960,5,67,72,,232,2,464
10756,9,3,12,,233,1,233
6216,1,32,33,,235,1,235
1632,5,135,140,,236,1,236
9790,1,14,15,,239,1,239
4463,19,6,25,,240,3,720
10064,26,33,59,,241,2,482
5722,19,2,21,,242,1,242
3310,101,37,138,,243,1,243
15039,4,3,7,,244,2,488
3764,8,5,13,,245,3,735
17472,1,5,6,,246,1,246
15992,3,6,9,,250,1,250
11408,5,1,6,,251,2,502
13392,3,6,9,,252,2,504
6372,5,2,7,,253,3,759
5465,21,78,99,,254,3,762
16218,23,8,31,,255,1,255
6657,12,6,18,,256,1,256
14273,6,2,8,,257,3,771
9590,9,15,24,,258,2,516
12771,2,2,4,,259,3,777
17157,5,0,5,,260,2,520
9476,9,1,10,,262,3,786
8287,5,22,27,,263,3,789
14631,1,0,1,,265,3,795
10210,46,27,73,,266,1,266
8200,142,72,214,,267,1,267
374,20,4,24,,269,1,269
1660,8,8,16,,270,2,540
16641,3,13,16,,272,2,544
9336,20,26,46,,275,4,1100
10367,23,26,49,,278,1,278
3075,43,38,81,,279,1,279
890,1,54,55,,280,3,840
1065,31,8,39,,283,2,566
15670,18,0,18,,286,1,286
9648,7,9,16,,287,2,574
8799,2,9,11,,289,3,867
12782,16,0,16,,293,1,293
6539,3,11,14,,294,1,294
876,2,77,79,,295,1,295
6895,27,31,58,,297,1,297
14573,38,22,60,,298,1,298
1173,1,1,2,,299,1,299
4764,19,0,19,,300,1,300
17325,3,11,14,,310,1,310
8997,39,1,40,,311,1,311
8438,86,1,87,,312,1,312
14798,2,0,2,,313,1,313
4420,21,7,28,,314,2,628
16907,4,0,4,,318,2,636
14642,11,6,17,,319,1,319
11692,29,30,59,,320,2,640
708,139,26,165,,323,1,323
4272,22,12,34,,324,2,648
417,17,4,21,,326,1,326
14709,5,8,13,,331,1,331
14140,11,9,20,,333,1,333
4597,7,17,24,,334,2,668
2144,25,15,40,,335,1,335
16028,35,5,40,,336,1,336
6628,8,12,20,,340,1,340
10556,15,18,33,,341,1,341
2997,42,17,59,,345,2,690
8689,1,2,3,,346,2,692
16797,3,0,3,,350,2,700
15455,5,4,9,,355,2,710
16715,17,5,22,,358,1,358
1833,56,48,104,,361,1,361
5399,84,101,185,,365,1,365
6776,6,4,10,,366,1,366
1353,14,25,39,,372,2,744
15674,7,1,8,,376,3,1128
4364,17,2,19,,377,1,377
11859,1,1,2,,382,1,382
729,46,112,158,,392,1,392
17438,6,3,9,,393,2,786
4392,6,1,7,,395,2,790
6081,15,11,26,,398,1,398
3375,25,11,36,,400,1,400
8666,8,0,8,,402,1,402
9310,3,10,13,,410,1,410
12922,25,1,26,,416,1,416
13648,4,10,14,,417,1,417
3937,1,1,2,,419,1,419
4577,9,1,10,,427,1,427
11916,7,24,31,,428,1,428
16154,4,6,10,,438,1,438
7763,7,3,10,,450,1,450
3356,14,3,17,,451,1,451
6796,29,10,39,,457,1,457
12353,11,30,41,,463,1,463
13910,3,1,4,,471,2,942
1181,103,24,127,,475,1,475
15380,6,54,60,,490,1,490
12623,6,1,7,,493,1,493
10113,4,0,4,,500,1,500
8611,5,3,8,,533,1,533
51,1,9,10,,545,1,545
16227,17,1,18,,555,1,555
14078,1,1,2,,561,1,561
13533,33,3,36,,584,1,584
11780,1,11,12,,599,1,599
14366,11,10,21,,610,1,610
11987,9,4,13,,784,1,784
8337,15,10,25,,,,
15323,1,3,4,,,,
8794,35,59,94,,,,
8484,6,7,13,,,,
13106,8,9,17,,,,
15683,5,14,19,,,,
3350,54,25,79,,,,
11786,4,8,12,,,,
14268,2,5,7,,,,
14155,6,6,12,,,,
6949,6,10,16,,,,
16474,7,6,13,,,,
5935,2,1,3,,,,
15930,2,1,3,,,,
2867,13,12,25,,,,
4695,54,1,55,,,,
6717,8,5,13,,,,
13266,4,4,8,,,,
2478,3,1,4,,,,
15839,1,0,1,,,,
17688,1,7,8,,,,
533,43,4,47,,,,
11120,1,12,13,,,,
13998,1,14,15,,,,
1853,16,16,32,,,,
4848,5,0,5,,,,
12860,6,1,7,,,,
7376,9,87,96,,,,
11051,1,8,9,,,,
3635,8,21,29,,,,
5197,5,9,14,,,,
9034,12,15,27,,,,
16445,8,0,8,,,,
3531,2,0,2,,,,
234,7,1,8,,,,
6972,1,8,9,,,,
14618,10,15,25,,,,
3166,20,60,80,,,,
17126,19,11,30,,,,
12804,1,2,3,,,,
10938,7,3,10,,,,
12561,32,14,46,,,,
15391,11,9,20,,,,
12781,1,0,1,,,,
10640,25,16,41,,,,
4814,19,28,47,,,,
9689,10,12,22,,,,
2994,13,19,32,,,,
1613,4,7,11,,,,
10266,12,4,16,,,,
2832,49,103,152,,,,
2076,2,3,5,,,,
16564,5,15,20,,,,
12459,67,9,76,,,,
9579,22,2,24,,,,
2059,16,14,30,,,,
12685,25,8,33,,,,
7209,3,1,4,,,,
2498,7,21,28,,,,
15667,1,0,1,,,,
2799,3,9,12,,,,
7839,17,18,35,,,,
14766,11,3,14,,,,
16777,7,2,9,,,,
11919,23,3,26,,,,
4721,10,27,37,,,,
6677,47,38,85,,,,
7929,1,12,13,,,,
14675,4,0,4,,,,
14771,10,11,21,,,,
5201,22,24,46,,,,
9502,7,6,13,,,,
4909,16,0,16,,,,
3733,11,23,34,,,,
10495,8,14,22,,,,
6288,2,20,22,,,,
12642,24,14,38,,,,
12878,6,13,19,,,,
9174,1,6,7,,,,
7205,7,25,32,,,,
5247,4,43,47,,,,
4058,14,42,56,,,,
11718,29,13,42,,,,
13223,12,21,33,,,,
15707,7,10,17,,,,
1275,42,89,131,,,,
4063,2,12,14,,,,
13526,1,25,26,,,,
4895,4,0,4,,,,
2269,260,27,287,,,,
2773,46,0,46,,,,
14579,16,69,85,,,,
4782,20,13,33,,,,
8247,4,3,7,,,,
13835,1,10,11,,,,
6234,21,6,27,,,,
2702,4,68,72,,,,
8639,9,9,18,,,,
793,40,43,83,,,,
13347,10,36,46,,,,
386,60,89,149,,,,
8869,26,0,26,,,,
4740,20,12,32,,,,
8436,67,41,108,,,,
3114,4,12,16,,,,
10046,6,14,20,,,,
5004,1,1,2,,,,
13538,14,4,18,,,,
1455,47,6,53,,,,
12360,2,11,13,,,,
42,6,2,8,,,,
11484,6,12,18,,,,
10983,4,7,11,,,,
12311,28,10,38,,,,
3270,48,5,53,,,,
11523,17,1,18,,,,
13130,2,6,8,,,,
8269,14,24,38,,,,
2541,2,12,14,,,,
8433,1,26,27,,,,
15365,23,0,23,,,,
3418,35,4,39,,,,
17601,6,7,13,,,,
4423,2,1,3,,,,
9408,3,6,9,,,,
1571,11,33,44,,,,
5350,194,14,208,,,,
17803,3,3,6,,,,
1042,5,0,5,,,,
920,5,17,22,,,,
16548,6,6,12,,,,
9155,6,6,12,,,,
9821,10,4,14,,,,
16142,9,5,14,,,,
9466,17,34,51,,,,
2114,2,5,7,,,,
6087,6,3,9,,,,
16847,1,2,3,,,,
9395,4,0,4,,,,
11232,10,10,20,,,,
1563,61,109,170,,,,
16769,2,3,5,,,,
1392,136,86,222,,,,
11842,3,10,13,,,,
14267,4,2,6,,,,
4672,4,77,81,,,,
12886,11,0,11,,,,
8683,3,37,40,,,,
11481,3,35,38,,,,
14010,6,6,12,,,,
7897,1,2,3,,,,
17292,25,8,33,,,,
11460,2,1,3,,,,
5401,35,166,201,,,,
14916,4,3,7,,,,
14419,4,0,4,,,,
9645,3,7,10,,,,
13497,9,0,9,,,,
6616,24,25,49,,,,
4356,7,0,7,,,,
16919,7,2,9,,,,
9818,2,3,5,,,,
15348,1,2,3,,,,
1500,1,0,1,,,,
12976,8,49,57,,,,
8764,4,3,7,,,,
11361,6,2,8,,,,
1692,13,41,54,,,,
657,28,68,96,,,,
8003,8,11,19,,,,
2137,120,7,127,,,,
13012,4,0,4,,,,
674,106,15,121,,,,
11855,1,0,1,,,,
16858,6,5,11,,,,
12759,12,13,25,,,,
13591,3,6,9,,,,
16038,39,19,58,,,,
11322,3,174,177,,,,
11401,2,2,4,,,,
6528,3,6,9,,,,
5599,12,18,30,,,,
11755,4,13,17,,,,
7098,27,13,40,,,,
15753,9,3,12,,,,
16937,2,7,9,,,,
9269,2,16,18,,,,
13694,38,4,42,,,,
2160,16,13,29,,,,
8596,1,27,28,,,,
5547,1,14,15,,,,
6098,24,36,60,,,,
10947,3,3,6,,,,
6656,24,2,26,,,,
13915,11,0,11,,,,
14846,10,7,17,,,,
3617,34,2,36,,,,
8025,2,7,9,,,,
9223,2,27,29,,,,
5432,52,41,93,,,,
6364,1,4,5,,,,
465,222,32,254,,,,
16499,6,0,6,,,,
11912,3,11,14,,,,
6647,41,12,53,,,,
1296,100,13,113,,,,
4106,24,7,31,,,,
495,1,1,2,,,,
3564,44,30,74,,,,
11689,27,16,43,,,,
5153,6,5,11,,,,
12655,1,3,4,,,,
7544,9,18,27,,,,
2889,4,7,11,,,,
211,8,1,9,,,,
12644,1,1,2,,,,
1407,29,10,39,,,,
16909,3,0,3,,,,
10787,12,10,22,,,,
1071,10,3,13,,,,
9443,10,4,14,,,,
3587,17,58,75,,,,
10604,28,44,72,,,,
5159,6,24,30,,,,
5684,18,1,19,,,,
10165,5,13,18,,,,
9016,14,68,82,,,,
14514,6,8,14,,,,
557,1,1,2,,,,
481,14,94,108,,,,
5557,8,26,34,,,,
14518,9,2,11,,,,
8271,5,18,23,,,,
3989,38,44,82,,,,
4179,5,11,16,,,,
10110,12,11,23,,,,
16716,5,0,5,,,,
11820,5,45,50,,,,
9430,4,2,6,,,,
16283,2,4,6,,,,
5320,37,6,43,,,,
9446,13,9,22,,,,
2170,21,1,22,,,,
12870,5,3,8,,,,
4013,31,4,35,,,,
7771,42,14,56,,,,
7261,5,7,12,,,,
16386,5,8,13,,,,
9065,3,4,7,,,,
12999,17,8,25,,,,
15159,1,4,5,,,,
8031,9,1,10,,,,
910,21,8,29,,,,
16767,3,0,3,,,,
11477,1,0,1,,,,
4135,12,20,32,,,,
8984,4,10,14,,,,
15224,1,3,4,,,,
16196,20,1,21,,,,
12378,1,10,11,,,,
7239,5,8,13,,,,
9662,4,39,43,,,,
227,1,1,2,,,,
17769,7,6,13,,,,
8451,8,2,10,,,,
13340,3,2,5,,,,
1573,51,192,243,,,,
5268,19,18,37,,,,
2104,8,15,23,,,,
10058,15,15,30,,,,
11980,3,7,10,,,,
4694,28,8,36,,,,
14329,2,9,11,,,,
16621,18,5,23,,,,
10461,21,22,43,,,,
15206,27,7,34,,,,
14409,1,2,3,,,,
886,2,21,23,,,,
12398,12,3,15,,,,
3325,9,26,35,,,,
13433,10,24,34,,,,
5418,95,122,217,,,,
7703,34,34,68,,,,
17392,3,0,3,,,,
11961,5,19,24,,,,
12425,8,11,19,,,,
17044,5,38,43,,,,
11651,8,1,9,,,,
16443,2,24,26,,,,
9938,3,3,6,,,,
1018,3,12,15,,,,
12075,13,28,41,,,,
12072,10,6,16,,,,
643,25,70,95,,,,
15905,10,0,10,,,,
11639,5,11,16,,,,
9707,1,2,3,,,,
2375,25,62,87,,,,
11585,21,12,33,,,,
11618,28,0,28,,,,
10181,20,47,67,,,,
4075,4,3,7,,,,
16699,2,16,18,,,,
1086,9,29,38,,,,
14213,36,1,37,,,,
6544,5,15,20,,,,
254,5,24,29,,,,
9752,10,1,11,,,,
9292,11,12,23,,,,
14722,2,2,4,,,,
1465,7,0,7,,,,
11511,14,15,29,,,,
6829,14,40,54,,,,
13773,2,7,9,,,,
12799,47,15,62,,,,
15141,6,1,7,,,,
3816,3,5,8,,,,
1734,27,8,35,,,,
4771,22,21,43,,,,
4143,8,22,30,,,,
4223,4,0,4,,,,
14978,31,9,40,,,,
8537,21,93,114,,,,
3861,1,0,1,,,,
5172,11,5,16,,,,
2061,25,8,33,,,,
4692,19,25,44,,,,
13528,10,9,19,,,,
10252,12,6,18,,,,
14725,6,1,7,,,,
3111,5,2,7,,,,
2025,17,0,17,,,,
12169,10,4,14,,,,
8724,7,20,27,,,,
15998,52,23,75,,,,
10202,11,3,14,,,,
15504,2,7,9,,,,
3511,3,9,12,,,,
3757,21,34,55,,,,
10882,8,1,9,,,,
5082,10,16,26,,,,
17405,6,4,10,,,,
13272,3,2,5,,,,
8154,32,41,73,,,,
14819,3,4,7,,,,
4273,7,2,9,,,,
6520,11,3,14,,,,
4537,37,2,39,,,,
7300,16,11,27,,,,
9129,2,8,10,,,,
1108,67,20,87,,,,
6721,20,11,31,,,,
8907,15,3,18,,,,
7997,21,18,39,,,,
14774,2,4,6,,,,
11615,9,1,10,,,,
1267,12,0,12,,,,
8564,1,23,24,,,,
7741,3,0,3,,,,
8366,8,32,40,,,,
12292,1,7,8,,,,
9990,1,8,9,,,,
14061,8,11,19,,,,
1593,46,143,189,,,,
17709,2,15,17,,,,
5088,7,5,12,,,,
10910,17,21,38,,,,
12876,4,3,7,,,,
8935,2,11,13,,,,
15300,6,11,17,,,,
423,23,43,66,,,,
9086,5,4,9,,,,
7149,8,2,10,,,,
16073,2,0,2,,,,
9487,2,3,5,,,,
14831,3,1,4,,,,
14406,1,2,3,,,,
11230,3,11,14,,,,
2193,4,9,13,,,,
14157,25,2,27,,,,
3099,5,29,34,,,,
5501,98,95,193,,,,
1915,39,18,57,,,,
10039,17,6,23,,,,
1974,18,26,44,,,,
12867,4,7,11,,,,
3214,1,7,8,,,,
14567,4,27,31,,,,
12153,1,0,1,,,,
253,17,9,26,,,,
112,68,92,160,,,,
10757,24,6,30,,,,
8137,20,70,90,,,,
8633,22,20,42,,,,
155,126,40,166,,,,
8487,7,18,25,,,,
17882,1,0,1,,,,
16834,2,4,6,,,,
14427,6,3,9,,,,
8881,11,15,26,,,,
13069,4,4,8,,,,
9718,4,34,38,,,,
13716,5,35,40,,,,
9207,19,9,28,,,,
3403,6,6,12,,,,
16062,15,7,22,,,,
9420,5,5,10,,,,
3161,28,24,52,,,,
14321,2,0,2,,,,
5533,19,19,38,,,,
7087,43,2,45,,,,
6910,20,13,33,,,,
6090,11,0,11,,,,
13453,3,2,5,,,,
15721,5,4,9,,,,
9609,7,2,9,,,,
1806,34,31,65,,,,
4295,2,11,13,,,,
14483,1,4,5,,,,
2424,81,4,85,,,,
4185,3,9,12,,,,
5054,16,12,28,,,,
4651,2,29,31,,,,
15518,4,0,4,,,,
2584,3,0,3,,,,
8872,5,9,14,,,,
3282,2,85,87,,,,
13177,11,29,40,,,,
13658,1,5,6,,,,
4905,5,0,5,,,,
3832,3,27,30,,,,
15557,1,0,1,,,,
6385,10,1,11,,,,
4558,52,29,81,,,,
1358,12,12,24,,,,
9733,34,10,44,,,,
11851,5,19,24,,,,
17697,1,1,2,,,,
3105,2,0,2,,,,
5710,4,0,4,,,,
9639,10,0,10,,,,
16846,5,0,5,,,,
8203,42,21,63,,,,
16257,3,8,11,,,,
6801,5,75,80,,,,
17741,5,0,5,,,,
1702,17,29,46,,,,
1133,1,32,33,,,,
6446,5,3,8,,,,
9951,17,12,29,,,,
5887,25,14,39,,,,
14437,3,3,6,,,,
1826,7,10,17,,,,
14420,7,18,25,,,,
17651,2,1,3,,,,
11642,7,18,25,,,,
10196,24,17,41,,,,
4799,30,24,54,,,,
15979,3,18,21,,,,
14283,25,46,71,,,,
9732,50,4,54,,,,
7380,22,2,24,,,,
8864,6,1,7,,,,
952,20,0,20,,,,
15731,16,12,28,,,,
9940,13,0,13,,,,
10003,3,2,5,,,,
16178,7,6,13,,,,
10924,24,32,56,,,,
17255,17,8,25,,,,
15607,2,7,9,,,,
12919,13,8,21,,,,
1792,72,72,144,,,,
3037,2,2,4,,,,
7016,1,0,1,,,,
16224,1,0,1,,,,
723,39,90,129,,,,
14390,3,2,5,,,,
7995,65,1,66,,,,
11569,19,16,35,,,,
12767,12,4,16,,,,
5751,6,0,6,,,,
15335,3,9,12,,,,
11772,8,71,79,,,,
6508,35,13,48,,,,
11913,2,2,4,,,,
6875,34,14,48,,,,
8796,1,5,6,,,,
10331,1,7,8,,,,
4901,3,8,11,,,,
7072,8,2,10,,,,
2674,174,236,410,,,,
15230,10,5,15,,,,
6521,48,14,62,,,,
9924,31,11,42,,,,
16833,4,8,12,,,,
9533,6,7,13,,,,
2029,7,0,7,,,,
1356,32,27,59,,,,
5662,113,5,118,,,,
1476,3,22,25,,,,
2998,28,20,48,,,,
10116,9,27,36,,,,
3895,61,7,68,,,,
14202,26,106,132,,,,
4367,83,18,101,,,,
11937,3,5,8,,,,
2010,18,28,46,,,,
804,110,25,135,,,,
4381,2,19,21,,,,
5297,39,9,48,,,,
6498,31,28,59,,,,
1009,57,7,64,,,,
1885,38,31,69,,,,
5216,4,10,14,,,,
12006,24,32,56,,,,
5609,4,17,21,,,,
2111,35,10,45,,,,
648,65,143,208,,,,
12984,14,0,14,,,,
1128,17,9,26,,,,
4070,28,1,29,,,,
1884,4,77,81,,,,
1203,12,1,13,,,,
1587,245,9,254,,,,
13286,2,1,3,,,,
12662,4,3,7,,,,
13157,11,7,18,,,,
7262,8,12,20,,,,
276,2,5,7,,,,
2372,9,86,95,,,,
232,2,11,13,,,,
4965,5,3,8,,,,
2481,28,15,43,,,,
6977,3,0,3,,,,
12700,11,1,12,,,,
511,2,0,2,,,,
5322,11,13,24,,,,
8979,8,43,51,,,,
14734,31,0,31,,,,
3433,63,7,70,,,,
11000,21,1,22,,,,
12594,1,3,4,,,,
1559,12,28,40,,,,
16974,2,1,3,,,,
10282,2,7,9,,,,
12494,13,5,18,,,,
16793,3,0,3,,,,
2126,3,29,32,,,,
16896,2,0,2,,,,
12744,2,1,3,,,,
5732,7,2,9,,,,
4010,31,40,71,,,,
696,53,42,95,,,,
16090,17,10,27,,,,
10442,8,5,13,,,,
11877,14,4,18,,,,
9191,3,0,3,,,,
106,10,392,402,,,,
4104,37,19,56,,,,
13483,2,3,5,,,,
1724,55,49,104,,,,
12835,6,5,11,,,,
6505,48,17,65,,,,
1033,7,47,54,,,,
16578,5,5,10,,,,
3559,25,8,33,,,,
10263,11,6,17,,,,
14364,2,8,10,,,,
4502,14,30,44,,,,
7540,10,19,29,,,,
9133,31,12,43,,,,
4355,25,6,31,,,,
16371,2,5,7,,,,
325,1,6,7,,,,
4189,8,23,31,,,,
14949,7,22,29,,,,
15476,15,6,21,,,,
6481,56,44,100,,,,
8275,2,3,5,,,,
11321,78,87,165,,,,
10200,15,20,35,,,,
13531,21,19,40,,,,
15614,8,0,8,,,,
16613,5,20,25,,,,
8807,2,19,21,,,,
12530,19,4,23,,,,
8629,6,33,39,,,,
9199,5,1,6,,,,
14769,1,2,3,,,,
4255,12,21,33,,,,
2769,6,3,9,,,,
13572,15,13,28,,,,
4641,1,12,13,,,,
5243,2,12,14,,,,
8750,1,3,4,,,,
187,21,20,41,,,,
539,6,19,25,,,,
16532,3,1,4,,,,
6110,13,3,16,,,,
3986,23,6,29,,,,
11348,6,0,6,,,,
16123,3,13,16,,,,
5941,4,0,4,,,,
514,35,26,61,,,,
9968,3,13,16,,,,
1491,1,1,2,,,,
10898,6,2,8,,,,
735,86,95,181,,,,
830,4,2,6,,,,
14461,1,12,13,,,,
6294,10,5,15,,,,
15315,2,5,7,,,,
9085,1,2,3,,,,
8503,4,3,7,,,,
11181,4,5,9,,,,
7736,8,11,19,,,,
13043,8,4,12,,,,
16843,6,5,11,,,,
6218,7,10,17,,,,
2759,16,2,18,,,,
246,2,29,31,,,,
13799,7,0,7,,,,
2202,10,1,11,,,,
4060,31,46,77,,,,
5640,12,4,16,,,,
17738,2,3,5,,,,
11902,19,9,28,,,,
6336,15,5,20,,,,
16275,14,1,15,,,,
1868,44,37,81,,,,
9198,37,10,47,,,,
15638,13,17,30,,,,
5000,9,20,29,,,,
11465,4,0,4,,,,
2212,9,0,9,,,,
13229,3,21,24,,,,
15246,26,12,38,,,,
9128,1,0,1,,,,
7663,18,14,32,,,,
11710,39,38,77,,,,
2676,76,8,84,,,,
11163,3,9,12,,,,
3906,37,88,125,,,,
2034,21,8,29,,,,
5575,3,5,8,,,,
13010,16,29,45,,,,
2712,35,55,90,,,,
2199,26,7,33,,,,
10284,7,1,8,,,,
6791,7,0,7,,,,
8551,10,0,10,,,,
15849,9,2,11,,,,
6059,49,36,85,,,,
13508,10,1,11,,,,
8403,20,13,33,,,,
5687,1,3,4,,,,
2836,46,25,71,,,,
5555,15,4,19,,,,
17217,2,2,4,,,,
1493,22,0,22,,,,
11025,17,1,18,,,,
3856,56,2,58,,,,
11690,22,21,43,,,,
12929,10,2,12,,,,
9102,2,1,3,,,,
15332,5,0,5,,,,
9625,19,23,42,,,,
552,47,125,172,,,,
9945,13,4,17,,,,
14665,1,24,25,,,,
15583,18,16,34,,,,
3304,11,65,76,,,,
13509,7,16,23,,,,
258,2,4,6,,,,
2801,26,4,30,,,,
12371,2,1,3,,,,
5260,11,6,17,,,,
10772,12,20,32,,,,
389,4,21,25,,,,
2704,31,3,34,,,,
12490,16,18,34,,,,
5514,29,172,201,,,,
15496,50,6,56,,,,
3474,34,8,42,,,,
16839,2,0,2,,,,
13026,1,12,13,,,,
10177,29,39,68,,,,
7377,2,8,10,,,,
9527,5,4,9,,,,
14062,7,8,15,,,,
10145,3,6,9,,,,
16646,8,2,10,,,,
8982,34,16,50,,,,
10460,1,58,59,,,,
356,25,3,28,,,,
7866,4,20,24,,,,
14416,7,1,8,,,,
14923,3,0,3,,,,
11243,16,7,23,,,,
6858,19,0,19,,,,
2356,15,7,22,,,,
17225,2,7,9,,,,
16997,7,1,8,,,,
296,6,10,16,,,,
12457,65,60,125,,,,
2354,20,47,67,,,,
2783,70,14,84,,,,
14519,6,8,14,,,,
15407,6,29,35,,,,
3399,6,31,37,,,,
9542,2,4,6,,,,
16030,38,6,44,,,,
6194,7,54,61,,,,
6594,2,4,6,,,,
14105,1,1,2,,,,
5396,121,27,148,,,,
1261,16,51,67,,,,
4499,9,29,38,,,,
7856,2,5,7,,,,
7379,9,0,9,,,,
15367,4,2,6,,,,
1541,5,0,5,,,,
5583,1,6,7,,,,
13664,2,8,10,,,,
15257,16,5,21,,,,
4493,5,6,11,,,,
13763,5,3,8,,,,
1365,15,41,56,,,,
14614,2,5,7,,,,
14182,8,70,78,,,,
782,13,32,45,,,,
10781,12,2,14,,,,
1939,25,13,38,,,,
14504,10,5,15,,,,
5370,127,73,200,,,,
450,3,1,4,,,,
10117,21,4,25,,,,
1861,58,20,78,,,,
11426,17,29,46,,,,
17241,1,9,10,,,,
8890,16,7,23,,,,
11439,4,5,9,,,,
1502,19,4,23,,,,
5134,5,1,6,,,,
6807,7,23,30,,,,
15567,4,24,28,,,,
12880,2,14,16,,,,
10324,4,2,6,,,,
3966,4,12,16,,,,
11730,31,40,71,,,,
287,13,15,28,,,,
9659,6,6,12,,,,
13682,1,5,6,,,,
2725,24,40,64,,,,
3070,1,1,2,,,,
5420,87,138,225,,,,
15219,10,4,14,,,,
11945,8,3,11,,,,
10559,22,6,28,,,,
10494,31,0,31,,,,
10866,2,3,5,,,,
8362,9,14,23,,,,
9399,20,10,30,,,,
16541,3,1,4,,,,
2228,11,16,27,,,,
5104,24,9,33,,,,
9376,31,1,32,,,,
14160,4,10,14,,,,
2103,1,4,5,,,,
7829,14,5,19,,,,
902,25,15,40,,,,
3894,2,2,4,,,,
6780,7,8,15,,,,
16995,1,0,1,,,,
9646,2,2,4,,,,
9616,137,21,158,,,,
8368,24,3,27,,,,
17664,2,2,4,,,,
4939,89,4,93,,,,
4300,1,3,4,,,,
17665,1,2,3,,,,
3061,1,11,12,,,,
1535,2,2,4,,,,
8688,3,4,7,,,,
17530,1,1,2,,,,
13038,5,3,8,,,,
15130,6,1,7,,,,
12684,9,27,36,,,,
10467,30,90,120,,,,
7932,3,3,6,,,,
13722,20,38,58,,,,
10783,38,11,49,,,,
10966,13,5,18,,,,
8140,1,87,88,,,,
12423,11,9,20,,,,
12920,14,2,16,,,,
2523,14,13,27,,,,
12203,8,13,21,,,,
2662,98,101,199,,,,
13353,1,2,3,,,,
10198,15,55,70,,,,
16147,1,4,5,,,,
7426,5,0,5,,,,
11725,46,2,48,,,,
6070,67,4,71,,,,
9575,35,10,45,,,,
3775,1,1,2,,,,
3301,56,3,59,,,,
14967,25,72,97,,,,
7927,41,1,42,,,,
3658,8,18,26,,,,
1741,60,182,242,,,,
4474,20,21,41,,,,
9369,3,2,5,,,,
5316,6,15,21,,,,
13762,3,7,10,,,,
10958,2,2,4,,,,
6839,14,40,54,,,,
1325,15,88,103,,,,
9262,3,40,43,,,,
15554,4,5,9,,,,
13468,3,6,9,,,,
7018,2,5,7,,,,
12902,8,1,9,,,,
6176,21,49,70,,,,
8566,1,5,6,,,,
5906,20,8,28,,,,
9650,9,11,20,,,,
15822,17,2,19,,,,
13900,6,2,8,,,,
15334,3,2,5,,,,
5062,9,13,22,,,,
5766,1,5,6,,,,
9099,35,2,37,,,,
16753,5,2,7,,,,
3488,6,6,12,,,,
7105,4,11,15,,,,
16526,3,1,4,,,,
7288,4,13,17,,,,
1623,183,52,235,,,,
5592,11,8,19,,,,
5049,20,11,31,,,,
3112,1,42,43,,,,
6284,2,5,7,,,,
16825,2,6,8,,,,
8257,3,24,27,,,,
4741,19,16,35,,,,
16308,17,6,23,,,,
1898,1,40,41,,,,
10753,4,12,16,,,,
14241,14,10,24,,,,
7874,15,7,22,,,,
293,4,17,21,,,,
9840,65,5,70,,,,
15936,9,1,10,,,,
8053,2,3,5,,,,
13123,1,9,10,,,,
10237,9,7,16,,,,
6451,1,3,4,,,,
5934,23,8,31,,,,
5848,5,1,6,,,,
1887,117,69,186,,,,
11378,4,1,5,,,,
15376,8,23,31,,,,
9091,49,4,53,,,,
5680,7,20,27,,,,
4829,2,1,3,,,,
16573,2,3,5,,,,
11423,1,34,35,,,,
16425,4,3,7,,,,
8736,13,0,13,,,,
4006,10,104,114,,,,
8429,3,4,7,,,,
4510,1,17,18,,,,
12547,7,18,25,,,,
17696,1,1,2,,,,
11504,10,13,23,,,,
14231,4,20,24,,,,
6327,80,34,114,,,,
12689,13,12,25,,,,
9816,6,7,13,,,,
2091,9,25,34,,,,
6737,46,0,46,,,,
2908,2,5,7,,,,
1557,113,23,136,,,,
3523,2,6,8,,,,
15649,20,12,32,,,,
17494,5,1,6,,,,
5865,7,52,59,,,,
9700,16,8,24,,,,
15055,7,14,21,,,,
8499,2,1,3,,,,
4032,16,3,19,,,,
3638,2,5,7,,,,
16941,1,2,3,,,,
17868,3,1,4,,,,
10530,62,10,72,,,,
1314,2,87,89,,,,
980,9,13,22,,,,
10546,22,0,22,,,,
10574,15,9,24,,,,
17065,1,21,22,,,,
12576,5,11,16,,,,
10735,2,3,5,,,,
16151,10,9,19,,,,
7645,24,8,32,,,,
12981,1,1,2,,,,
12021,15,3,18,,,,
12306,18,0,18,,,,
9761,7,33,40,,,,
10670,1,2,3,,,,
7199,9,4,13,,,,
4344,129,1,130,,,,
13122,9,9,18,,,,
11974,7,3,10,,,,
7137,1,18,19,,,,
9716,35,12,47,,,,
12316,34,10,44,,,,
3296,55,25,80,,,,
5658,29,7,36,,,,
7418,9,2,11,,,,
5421,146,37,183,,,,
12614,4,0,4,,,,
17294,12,8,20,,,,
615,17,4,21,,,,
15053,1,7,8,,,,
11303,1,4,5,,,,
4921,9,21,30,,,,
5064,3,27,30,,,,
2872,13,28,41,,,,
977,15,1,16,,,,
13760,2,2,4,,,,
1078,17,3,20,,,,
5245,73,5,78,,,,
352,8,7,15,,,,
13276,3,5,8,,,,
8143,33,72,105,,,,
5756,1,3,4,,,,
8235,37,6,43,,,,
10115,12,11,23,,,,
3705,3,2,5,,,,
15027,4,10,14,,,,
3096,10,11,21,,,,
6882,4,2,6,,,,
5737,1,1,2,,,,
344,4,9,13,,,,
13351,13,2,15,,,,
14479,9,0,9,,,,
15103,8,24,32,,,,
17715,4,2,6,,,,
12631,14,2,16,,,,
7835,9,9,18,,,,
3576,5,4,9,,,,
5388,29,173,202,,,,
2271,41,122,163,,,,
8093,1,2,3,,,,
15117,2,6,8,,,,
10031,2,6,8,,,,
2351,17,20,37,,,,
5730,30,23,53,,,,
284,16,4,20,,,,
15507,4,8,12,,,,
14394,5,3,8,,,,
6676,20,42,62,,,,
6354,3,17,20,,,,
4634,7,34,41,,,,
4919,4,3,7,,,,
9083,4,1,5,,,,
13784,8,1,9,,,,
17318,2,2,4,,,,
5927,17,9,26,,,,
15311,3,7,10,,,,
8592,1,8,9,,,,
12284,2,0,2,,,,
12535,48,3,51,,,,
9704,8,6,14,,,,
7629,3,25,28,,,,
14076,1,7,8,,,,
7118,1,70,71,,,,
9322,7,5,12,,,,
2065,1,0,1,,,,
2409,25,28,53,,,,
8959,5,36,41,,,,
4755,14,48,62,,,,
10844,7,14,21,,,,
5800,5,11,16,,,,
9920,6,42,48,,,,
13404,5,0,5,,,,
2619,9,20,29,,,,
496,1,0,1,,,,
7975,1,6,7,,,,
9296,7,0,7,,,,
9283,8,0,8,,,,
15082,8,13,21,,,,
5475,1,90,91,,,,
7509,3,11,14,,,,
606,102,7,109,,,,
2805,13,0,13,,,,
9640,3,10,13,,,,
5706,15,10,25,,,,
1717,34,20,54,,,,
15156,16,0,16,,,,
4774,18,2,20,,,,
12575,1,8,9,,,,
15792,5,2,7,,,,
13987,5,2,7,,,,
5591,5,9,14,,,,
4269,69,30,99,,,,
13539,8,37,45,,,,
2344,6,62,68,,,,
1239,6,1,7,,,,
11086,1,0,1,,,,
14765,22,0,22,,,,
255,11,1,12,,,,
14402,10,25,35,,,,
16463,1,2,3,,,,
2412,38,58,96,,,,
10223,5,11,16,,,,
13033,7,3,10,,,,
8075,3,0,3,,,,
6201,12,18,30,,,,
9136,5,22,27,,,,
123,22,88,110,,,,
9971,19,1,20,,,,
15289,4,5,9,,,,
1899,14,8,22,,,,
1120,19,11,30,,,,
7421,6,1,7,,,,
6974,7,1,8,,,,
1788,30,11,41,,,,
11102,9,16,25,,,,
4376,1,12,13,,,,
8774,17,19,36,,,,
16635,8,2,10,,,,
16411,2,0,2,,,,
17173,6,4,10,,,,
2503,16,32,48,,,,
4880,5,1,6,,,,
17059,37,2,39,,,,
9627,37,0,37,,,,
14310,4,3,7,,,,
16536,3,4,7,,,,
2261,31,2,33,,,,
16986,6,14,20,,,,
9565,2,57,59,,,,
15720,4,10,14,,,,
14755,3,18,21,,,,
9402,1,3,4,,,,
15336,2,8,10,,,,
14217,26,0,26,,,,
12901,1,6,7,,,,
6264,47,15,62,,,,
5358,130,91,221,,,,
9248,42,7,49,,,,
4318,1,44,45,,,,
9284,5,13,18,,,,
10203,6,0,6,,,,
5478,147,78,225,,,,
7057,7,1,8,,,,
11899,11,1,12,,,,
683,64,97,161,,,,
12671,1,4,5,,,,
6213,26,53,79,,,,
14405,10,1,11,,,,
2993,19,51,70,,,,
1951,49,14,63,,,,
10702,6,48,54,,,,
3863,28,6,34,,,,
4674,4,32,36,,,,
12358,24,1,25,,,,
9678,11,8,19,,,,
3771,27,13,40,,,,
3060,48,4,52,,,,
2444,62,84,146,,,,
8315,2,3,5,,,,
2156,3,8,11,,,,
7,7,0,7,,,,
703,9,0,9,,,,
4591,8,2,10,,,,
13196,74,10,84,,,,
10763,26,1,27,,,,
5724,9,0,9,,,,
4460,18,3,21,,,,
10149,8,4,12,,,,
2135,5,0,5,,,,
8966,11,14,25,,,,
1012,1,6,7,,,,
12418,3,3,6,,,,
7697,4,12,16,,,,
2423,43,7,50,,,,
3619,11,3,14,,,,
5885,31,59,90,,,,
14468,2,1,3,,,,
3903,18,2,20,,,,
11099,4,6,10,,,,
3212,9,0,9,,,,
9899,11,2,13,,,,
6105,50,18,68,,,,
10631,19,40,59,,,,
9438,7,1,8,,,,
8844,29,20,49,,,,
5899,2,2,4,,,,
488,10,3,13,,,,
371,20,0,20,,,,
12833,17,1,18,,,,
6865,57,10,67,,,,
15216,7,3,10,,,,
12643,8,27,35,,,,
3344,21,20,41,,,,
759,168,83,251,,,,
5089,2,5,7,,,,
9538,4,2,6,,,,
244,6,19,25,,,,
16214,11,6,17,,,,
17733,1,7,8,,,,
2873,38,6,44,,,,
17134,25,2,27,,,,
2368,57,18,75,,,,
3630,9,4,13,,,,
12192,5,6,11,,,,
2177,15,0,15,,,,
10167,1,0,1,,,,
17504,9,1,10,,,,
7700,4,1,5,,,,
12405,5,0,5,,,,
8319,16,40,56,,,,
2161,15,8,23,,,,
8114,6,4,10,,,,
8637,15,7,22,,,,
1109,19,5,24,,,,
2768,24,6,30,,,,
8011,21,9,30,,,,
14009,1,1,2,,,,
13950,13,21,34,,,,
16634,5,2,7,,,,
306,13,4,17,,,,
4539,17,95,112,,,,
5414,47,127,174,,,,
13370,10,2,12,,,,
13813,18,2,20,,,,
5267,55,2,57,,,,
9520,3,25,28,,,,
10315,5,9,14,,,,
9715,6,44,50,,,,
11665,50,6,56,,,,
9820,22,16,38,,,,
6093,2,28,30,,,,
4865,61,10,71,,,,
8805,2,3,5,,,,
2822,7,3,10,,,,
16396,15,5,20,,,,
4870,2,0,2,,,,
16434,1,5,6,,,,
14865,6,1,7,,,,
6438,14,7,21,,,,
16954,2,2,4,,,,
2421,86,77,163,,,,
66,31,84,115,,,,
6035,3,8,11,,,,
10588,8,6,14,,,,
4021,1,3,4,,,,
12809,12,14,26,,,,
15303,15,0,15,,,,
2153,1,3,4,,,,
9483,10,6,16,,,,
1649,4,22,26,,,,
10609,1,1,2,,,,
4748,6,9,15,,,,
16212,6,11,17,,,,
6335,103,17,120,,,,
4160,1,2,3,,,,
5513,108,81,189,,,,
9799,7,9,16,,,,
9363,1,6,7,,,,
14473,2,1,3,,,,
17487,7,9,16,,,,
12927,7,7,14,,,,
2824,1,23,24,,,,
7215,23,26,49,,,,
1422,112,5,117,,,,
12958,5,5,10,,,,
8803,18,27,45,,,,
13003,3,3,6,,,,
17724,1,4,5,,,,
1281,5,3,8,,,,
4632,19,1,20,,,,
8908,5,3,8,,,,
16040,9,21,30,,,,
5707,1,8,9,,,,
9603,1,34,35,,,,
8376,86,4,90,,,,
15870,1,1,2,,,,
5537,4,0,4,,,,
17138,3,4,7,,,,
2688,2,39,41,,,,
10857,5,15,20,,,,
1997,22,24,46,,,,
8567,7,5,12,,,,
1483,96,17,113,,,,
8054,10,1,11,,,,
12511,12,26,38,,,,
16901,1,1,2,,,,
12741,6,2,8,,,,
8995,14,36,50,,,,
13222,82,35,117,,,,
14356,10,13,23,,,,
8933,8,14,22,,,,
8722,32,12,44,,,,
2427,13,22,35,,,,
15400,47,16,63,,,,
9247,29,0,29,,,,
15733,4,10,14,,,,
7660,2,13,15,,,,
13228,1,2,3,,,,
2863,30,8,38,,,,
5449,192,24,216,,,,
921,94,2,96,,,,
14077,7,11,18,,,,
1905,238,14,252,,,,
9206,5,1,6,,,,
17414,6,1,7,,,,
8822,2,2,4,,,,
12219,13,4,17,,,,
16173,2,2,4,,,,
9468,35,28,63,,,,
17452,11,15,26,,,,
17532,2,2,4,,,,
1298,86,6,92,,,,
9015,106,13,119,,,,
8700,1,18,19,,,,
16482,6,6,12,,,,
9914,14,3,17,,,,
10404,6,12,18,,,,
16383,7,1,8,,,,
2962,3,114,117,,,,
2569,4,11,15,,,,
6348,24,3,27,,,,
4913,6,3,9,,,,
3181,16,2,18,,,,
5252,8,10,18,,,,
5907,3,1,4,,,,
1434,41,82,123,,,,
14801,1,17,18,,,,
13646,15,24,39,,,,
13541,5,2,7,,,,
1930,70,2,72,,,,
14277,5,34,39,,,,
1979,11,19,30,,,,
2511,36,1,37,,,,
9246,3,12,15,,,,
8383,6,0,6,,,,
12001,65,20,85,,,,
15585,12,3,15,,,,
14194,28,68,96,,,,
591,9,5,14,,,,
6565,18,13,31,,,,
8624,16,19,35,,,,
11735,52,9,61,,,,
16982,4,2,6,,,,
6064,6,1,7,,,,
10755,15,0,15,,,,
14972,5,12,17,,,,
4190,9,19,28,,,,
14705,11,18,29,,,,
15211,9,0,9,,,,
7628,11,0,11,,,,
12275,5,7,12,,,,
4613,7,46,53,,,,
12489,8,11,19,,,,
13248,9,10,19,,,,
16840,5,1,6,,,,
17486,1,15,16,,,,
11432,3,5,8,,,,
15422,7,0,7,,,,
14123,1,0,1,,,,
17443,6,3,9,,,,
6022,3,9,12,,,,
1716,20,101,121,,,,
1703,57,42,99,,,,
15584,8,2,10,,,,
1766,11,1,12,,,,
7657,10,9,19,,,,
9771,2,7,9,,,,
8545,16,130,146,,,,
13274,1,3,4,,,,
2733,1,23,24,,,,
2298,28,52,80,,,,
4275,11,52,63,,,,
16004,3,46,49,,,,
12424,1,3,4,,,,
5112,49,1,50,,,,
17686,2,1,3,,,,
3814,78,3,81,,,,
15624,7,8,15,,,,
11295,11,2,13,,,,
16967,1,2,3,,,,
14906,4,3,7,,,,
4970,40,2,42,,,,
2765,19,10,29,,,,
7751,7,1,8,,,,
11943,22,0,22,,,,
10216,6,9,15,,,,
2435,159,7,166,,,,
6042,5,3,8,,,,
15123,2,0,2,,,,
11879,7,1,8,,,,
9158,6,8,14,,,,
15804,22,9,31,,,,
1321,46,33,79,,,,
12564,3,0,3,,,,
17024,1,2,3,,,,
133,100,21,121,,,,
13599,2,3,5,,,,
3194,4,4,8,,,,
16115,12,2,14,,,,
15361,9,0,9,,,,
3091,10,9,19,,,,
15612,3,14,17,,,,
1189,4,17,21,,,,
15119,2,6,8,,,,
7779,11,4,15,,,,
3962,14,19,33,,,,
8232,47,14,61,,,,
15417,10,17,27,,,,
16755,1,4,5,,,,
5691,3,0,3,,,,
11897,6,11,17,,,,
13850,4,3,7,,,,
16300,8,2,10,,,,
319,1,2,3,,,,
3039,4,44,48,,,,
12011,11,7,18,,,,
3241,29,9,38,,,,
17100,2,4,6,,,,
11033,12,1,13,,,,
3244,7,18,25,,,,
11319,1,2,3,,,,
17502,3,5,8,,,,
4233,5,8,13,,,,
13928,2,0,2,,,,
1368,36,5,41,,,,
12149,8,2,10,,,,
12232,13,23,36,,,,
5845,6,9,15,,,,
5232,6,19,25,,,,
15978,17,2,19,,,,
6302,33,20,53,,,,
10098,44,22,66,,,,
16310,7,4,11,,,,
10814,8,2,10,,,,
385,70,42,112,,,,
9429,1,0,1,,,,
13014,1,3,4,,,,
376,17,7,24,,,,
186,18,33,51,,,,
6096,2,2,4,,,,
8516,30,45,75,,,,
3972,6,0,6,,,,
10004,4,1,5,,,,
9294,13,0,13,,,,
12110,21,4,25,,,,
3572,1,1,2,,,,
4752,34,40,74,,,,
2016,1,26,27,,,,
8985,16,11,27,,,,
748,49,20,69,,,,
15949,2,0,2,,,,
13256,8,66,74,,,,
8365,9,1,10,,,,
3483,34,96,130,,,,
16145,1,1,2,,,,
12856,2,7,9,,,,
7284,1,1,2,,,,
5471,82,5,87,,,,
15028,4,7,11,,,,
13746,6,7,13,,,,
1757,166,45,211,,,,
5128,13,1,14,,,,
4020,5,1,6,,,,
1164,3,1,4,,,,
3839,138,13,151,,,,
6464,5,9,14,,,,
8767,7,8,15,,,,
11542,2,6,8,,,,
11978,3,5,8,,,,
14617,21,9,30,,,,
15652,2,8,10,,,,
15961,2,1,3,,,,
2807,6,3,9,,,,
13771,3,17,20,,,,
7097,29,3,32,,,,
14556,57,17,74,,,,
5161,6,0,6,,,,
630,7,24,31,,,,
5284,14,54,68,,,,
1855,10,21,31,,,,
12249,15,1,16,,,,
1433,38,94,132,,,,
17559,2,7,9,,,,
3519,19,9,28,,,,
10766,1,0,1,,,,
10835,1,6,7,,,,
14547,54,6,60,,,,
7519,79,29,108,,,,
15057,5,5,10,,,,
5797,9,5,14,,,,
15241,11,21,32,,,,
1008,8,5,13,,,,
6057,72,35,107,,,,
6590,18,5,23,,,,
17118,9,0,9,,,,
464,1,3,4,,,,
17142,3,0,3,,,,
13056,19,12,31,,,,
16697,21,5,26,,,,
10532,35,19,54,,,,
9864,8,24,32,,,,
8401,8,7,15,,,,
8550,6,2,8,,,,
6108,37,63,100,,,,
10129,3,8,11,,,,
5127,4,0,4,,,,
15434,23,11,34,,,,
17314,1,1,2,,,,
11148,1,3,4,,,,
4212,25,15,40,,,,
11312,1,0,1,,,,
3597,10,1,11,,,,
839,13,1,14,,,,
6486,35,17,52,,,,
14876,15,10,25,,,,
7165,35,1,36,,,,
3426,1,2,3,,,,
9977,38,29,67,,,,
2877,27,6,33,,,,
7596,74,23,97,,,,
4264,124,1,125,,,,
3333,2,3,5,,,,
17624,3,6,9,,,,
940,11,20,31,,,,
1438,1,16,17,,,,
10890,12,6,18,,,,
8780,38,29,67,,,,
1609,149,35,184,,,,
6196,4,1,5,,,,
6471,8,1,9,,,,
14183,3,84,87,,,,
14281,1,9,10,,,,
13193,15,18,33,,,,
5407,56,123,179,,,,
13564,2,27,29,,,,
6602,4,8,12,,,,
11994,1,14,15,,,,
9891,26,4,30,,,,
292,22,11,33,,,,
17625,3,8,11,,,,
1580,114,7,121,,,,
6078,4,12,16,,,,
16029,58,2,60,,,,
3203,51,3,54,,,,
16465,4,0,4,,,,
9726,1,30,31,,,,
7078,14,8,22,,,,
7351,6,13,19,,,,
7253,14,14,28,,,,
16021,29,24,53,,,,
6571,39,23,62,,,,
15501,6,13,19,,,,
14377,7,0,7,,,,
4218,162,50,212,,,,
1390,117,32,149,,,,
11746,4,7,11,,,,
2781,2,2,4,,,,
16330,31,14,45,,,,
1754,570,29,599,,,,
13299,8,1,9,,,,
1791,47,141,188,,,,
16513,3,12,15,,,,
2533,9,1,10,,,,
10390,7,13,20,,,,
10272,4,3,7,,,,
13194,1,8,9,,,,
11748,6,24,30,,,,
8766,1,1,2,,,,
8309,17,7,24,,,,
17615,7,0,7,,,,
1992,4,28,32,,,,
1800,6,20,26,,,,
15648,10,14,24,,,,
7169,3,19,22,,,,
12540,40,31,71,,,,
14346,4,3,7,,,,
14880,29,13,42,,,,
12583,1,1,2,,,,
14813,7,15,22,,,,
1162,25,7,32,,,,
14837,11,40,51,,,,
6002,1,7,8,,,,
9585,8,4,12,,,,
14069,30,10,40,,,,
2564,5,6,11,,,,
3821,2,0,2,,,,
15824,6,2,8,,,,
16404,21,8,29,,,,
17511,4,0,4,,,,
11928,6,9,15,,,,
14559,27,6,33,,,,
15853,2,1,3,,,,
16969,2,2,4,,,,
13652,3,3,6,,,,
8760,3,2,5,,,,
14257,2,5,7,,,,
17458,6,7,13,,,,
8920,5,2,7,,,,
17073,3,2,5,,,,
7860,7,18,25,,,,
8918,15,7,22,,,,
10579,8,5,13,,,,
1811,75,117,192,,,,
141,59,238,297,,,,
452,15,89,104,,,,
16510,5,1,6,,,,
4622,4,27,31,,,,
13735,2,29,31,,,,
14492,1,1,2,,,,
15660,6,2,8,,,,
16544,3,5,8,,,,
6204,29,46,75,,,,
7557,50,41,91,,,,
8138,51,26,77,,,,
11749,2,3,5,,,,
7467,9,0,9,,,,
6045,17,67,84,,,,
16320,5,8,13,,,,
17600,11,1,12,,,,
2471,2,17,19,,,,
13431,1,4,5,,,,
4526,67,47,114,,,,
16612,1,8,9,,,,
6271,24,100,124,,,,
6554,4,3,7,,,,
10480,36,18,54,,,,
17364,31,1,32,,,,
9080,17,3,20,,,,
17584,5,7,12,,,,
8347,4,10,14,,,,
13434,3,3,6,,,,
17441,6,2,8,,,,
12377,7,4,11,,,,
9560,24,18,42,,,,
8133,45,37,82,,,,
13462,3,18,21,,,,
13893,22,7,29,,,,
5632,12,28,40,,,,
14100,7,9,16,,,,
3358,10,17,27,,,,
9871,17,21,38,,,,
5701,3,9,12,,,,
12433,8,13,21,,,,
9638,5,0,5,,,,
16760,1,0,1,,,,
4813,25,10,35,,,,
7559,12,27,39,,,,
401,156,31,187,,,,
14355,3,5,8,,,,
953,19,7,26,,,,
8251,19,22,41,,,,
14498,2,0,2,,,,
14279,5,7,12,,,,
5952,2,3,5,,,,
686,3,8,11,,,,
16424,3,9,12,,,,
8187,23,19,42,,,,
2216,1,10,11,,,,
7620,7,3,10,,,,
4923,16,0,16,,,,
17440,1,0,1,,,,
11454,2,0,2,,,,
8923,3,1,4,,,,
3555,7,8,15,,,,
4700,1,2,3,,,,
17654,5,8,13,,,,
9817,3,4,7,,,,
7371,2,7,9,,,,
6964,28,21,49,,,,
11939,1,10,11,,,,
784,3,3,6,,,,
4199,42,4,46,,,,
16331,2,3,5,,,,
2933,7,27,34,,,,
17303,4,1,5,,,,
12214,3,2,5,,,,
12258,1,6,7,,,,
7554,11,11,22,,,,
13691,9,1,10,,,,
3415,30,56,86,,,,
3022,26,26,52,,,,
4876,4,0,4,,,,
16464,3,6,9,,,,
14671,14,1,15,,,,
12674,7,2,9,,,,
12242,11,7,18,,,,
15508,1,2,3,,,,
8177,18,19,37,,,,
13568,8,3,11,,,,
6808,91,6,97,,,,
1341,66,48,114,,,,
9708,10,2,12,,,,
14604,2,3,5,,,,
14337,4,4,8,,,,
3979,5,6,11,,,,
11069,11,6,17,,,,
15679,5,12,17,,,,
4816,46,5,51,,,,
5144,3,34,37,,,,
2133,6,0,6,,,,
10655,48,28,76,,,,
2913,41,7,48,,,,
11759,19,30,49,,,,
10280,4,2,6,,,,
11417,22,22,44,,,,
9660,12,19,31,,,,
4434,2,0,2,,,,
2329,29,25,54,,,,
16768,3,5,8,,,,
5794,2,0,2,,,,
2833,60,38,98,,,,
3810,2,9,11,,,,
5246,56,17,73,,,,
14720,8,6,14,,,,
16410,3,0,3,,,,
12344,24,9,33,,,,
8521,7,95,102,,,,
17739,10,3,13,,,,
15701,5,0,5,,,,
3857,3,60,63,,,,
8089,29,3,32,,,,
15467,1,1,2,,,,
11177,34,8,42,,,,
15185,18,1,19,,,,
16182,5,3,8,,,,
6555,8,6,14,,,,
13703,9,1,10,,,,
5158,3,2,5,,,,
8464,3,1,4,,,,
16083,2,18,20,,,,
17544,5,5,10,,,,
13751,4,1,5,,,,
519,2,2,4,,,,
13036,10,9,19,,,,
13099,2,7,9,,,,
4614,75,7,82,,,,
5681,2,1,3,,,,
829,8,4,12,,,,
17578,2,3,5,,,,
12827,18,27,45,,,,
6478,5,6,11,,,,
2462,8,12,20,,,,
278,20,10,30,,,,
9804,4,5,9,,,,
1149,33,3,36,,,,
476,44,35,79,,,,
3332,4,2,6,,,,
10332,5,1,6,,,,
3321,39,38,77,,,,
14016,1,6,7,,,,
5166,5,2,7,,,,
14412,20,20,40,,,,
5205,29,23,52,,,,
16134,12,1,13,,,,
9688,9,11,20,,,,
5071,18,1,19,,,,
5462,86,112,198,,,,
875,36,3,39,,,,
4429,23,17,40,,,,
15841,2,0,2,,,,
2022,8,2,10,,,,
610,5,18,23,,,,
1805,5,4,9,,,,
1539,15,5,20,,,,
2903,6,14,20,,,,
10618,28,12,40,,,,
9222,25,26,51,,,,
11260,3,3,6,,,,
16772,7,13,20,,,,
14752,3,2,5,,,,
7311,1,0,1,,,,
14921,8,11,19,,,,
1618,13,11,24,,,,
4216,1,29,30,,,,
125,3,6,9,,,,
7762,13,14,27,,,,
62,25,182,207,,,,
13870,5,0,5,,,,
16256,9,1,10,,,,
7809,21,1,22,,,,
16239,5,0,5,,,,
15473,1,3,4,,,,
10953,1,2,3,,,,
10183,45,0,45,,,,
4720,22,5,27,,,,
7556,14,6,20,,,,
4543,23,11,34,,,,
15599,1,17,18,,,,
14520,13,1,14,,,,
10092,9,22,31,,,,
3884,3,106,109,,,,
8327,33,13,46,,,,
4669,11,12,23,,,,
15244,12,28,40,,,,
15645,13,24,37,,,,
16860,3,14,17,,,,
4126,7,9,16,,,,
14238,1,1,2,,,,
7793,1,0,1,,,,
12957,1,1,2,,,,
1463,17,14,31,,,,
17336,2,1,3,,,,
9252,1,2,3,,,,
6894,27,39,66,,,,
12608,4,14,18,,,,
8921,9,0,9,,,,
2295,196,29,225,,,,
12760,17,2,19,,,,
11168,7,21,28,,,,
8297,7,11,18,,,,
7778,6,15,21,,,,
3360,16,46,62,,,,
7691,49,58,107,,,,
11673,11,19,30,,,,
10016,1,8,9,,,,
8527,36,28,64,,,,
6008,1,1,2,,,,
6200,84,40,124,,,,
10487,12,4,16,,,,
7102,3,0,3,,,,
3018,1,1,2,,,,
17211,1,4,5,,,,
11105,12,9,21,,,,
1888,3,18,21,,,,
34,7,13,20,,,,
11646,16,1,17,,,,
14593,6,1,7,,,,
15570,5,31,36,,,,
10657,15,2,17,,,,
11546,2,5,7,,,,
2191,2,5,7,,,,
11307,3,18,21,,,,
15916,1,0,1,,,,
16081,1,19,20,,,,
4681,3,52,55,,,,
2973,7,22,29,,,,
10525,21,20,41,,,,
8107,1,12,13,,,,
9307,2,12,14,,,,
15018,1,7,8,,,,
4728,32,0,32,,,,
1598,85,80,165,,,,
11736,7,9,16,,,,
9592,7,22,29,,,,
17347,14,0,14,,,,
409,56,41,97,,,,
15840,12,4,16,,,,
13197,44,41,85,,,,
6043,3,0,3,,,,
6224,295,60,355,,,,
10232,10,26,36,,,,
14638,15,1,16,,,,
2213,21,3,24,,,,
13997,8,3,11,,,,
13381,2,1,3,,,,
2477,6,25,31,,,,
10879,14,0,14,,,,
12639,16,17,33,,,,
5854,2,13,15,,,,
4874,7,4,11,,,,
9601,1,9,10,,,,
8442,26,16,42,,,,
13247,19,8,27,,,,
3094,23,6,29,,,,
11297,5,5,10,,,,
4067,25,21,46,,,,
14983,19,15,34,,,,
5758,12,68,80,,,,
7123,8,9,17,,,,
13714,2,8,10,,,,
10625,32,7,39,,,,
17176,2,2,4,,,,
14399,2,2,4,,,,
3898,1,34,35,,,,
15768,2,2,4,,,,
9637,57,26,83,,,,
2455,5,18,23,,,,
2460,4,17,21,,,,
3351,22,4,26,,,,
11434,5,4,9,,,,
12800,1,10,11,,,,
9877,1,5,6,,,,
6670,24,92,116,,,,
10718,5,4,9,,,,
9345,15,2,17,,,,
5240,6,9,15,,,,
3247,56,194,250,,,,
4734,21,33,54,,,,
4441,41,3,44,,,,
9497,1,11,12,,,,
12099,17,9,26,,,,
16207,17,4,21,,,,
7513,180,45,225,,,,
705,27,2,29,,,,
13359,11,5,16,,,,
9578,21,12,33,,,,
15014,9,10,19,,,,
16867,9,7,16,,,,
14387,20,0,20,,,,
5046,20,18,38,,,,
8752,4,5,9,,,,
3532,1,1,2,,,,
10107,11,2,13,,,,
4516,42,19,61,,,,
14894,2,23,25,,,,
1988,69,29,98,,,,
8901,5,0,5,,,,
10597,3,4,7,,,,
3949,26,9,35,,,,
15859,1,1,2,,,,
10293,4,1,5,,,,
11240,17,47,64,,,,
1056,41,13,54,,,,
11567,12,3,15,,,,
17329,14,0,14,,,,
11404,50,6,56,,,,
3928,24,27,51,,,,
8443,12,35,47,,,,
4500,41,14,55,,,,
5369,129,77,206,,,,
5747,40,11,51,,,,
3062,6,44,50,,,,
10142,2,2,4,,,,
13219,11,4,15,,,,
3725,20,9,29,,,,
9177,10,10,20,,,,
5183,5,0,5,,,,
5803,18,10,28,,,,
379,14,31,45,,,,
7846,14,8,22,,,,
13421,14,2,16,,,,
11394,16,8,24,,,,
9124,6,5,11,,,,
867,11,19,30,,,,
12114,3,6,9,,,,
7058,6,11,17,,,,
6099,58,31,89,,,,
13335,13,2,15,,,,
10815,1,32,33,,,,
3650,4,4,8,,,,
9147,10,8,18,,,,
6710,2,22,24,,,,
4706,19,15,34,,,,
1072,11,13,24,,,,
14835,6,16,22,,,,
6654,14,3,17,,,,
17182,2,4,6,,,,
2671,216,59,275,,,,
14982,1,32,33,,,,
11513,7,5,12,,,,
14359,7,29,36,,,,
7706,5,6,11,,,,
17299,2,4,6,,,,
3185,24,74,98,,,,
1807,67,79,146,,,,
10995,25,4,29,,,,
12954,3,3,6,,,,
14074,6,0,6,,,,
6868,6,8,14,,,,
12413,29,5,34,,,,
1657,6,13,19,,,,
3759,13,13,26,,,,
5698,1,13,14,,,,
13535,6,20,26,,,,
17794,1,4,5,,,,
10598,5,0,5,,,,
12562,1,3,4,,,,
6286,18,22,40,,,,
5446,40,109,149,,,,
1775,9,27,36,,,,
3784,1,1,2,,,,
3429,61,20,81,,,,
13113,4,44,48,,,,
13126,6,9,15,,,,
16417,30,26,56,,,,
4585,1,31,32,,,,
5156,31,9,40,,,,
9021,1,31,32,,,,
6640,17,20,37,,,,
8578,36,27,63,,,,
13819,8,2,10,,,,
8233,3,1,4,,,,
11352,1,3,4,,,,
15388,33,3,36,,,,
17185,8,9,17,,,,
15271,3,0,3,,,,
14856,10,0,10,,,,
11619,4,1,5,,,,
8690,2,4,6,,,,
7423,7,4,11,,,,
691,24,179,203,,,,
154,20,8,28,,,,
8380,14,14,28,,,,
15480,3,4,7,,,,
487,1,1,2,,,,
4533,17,56,73,,,,
2995,9,16,25,,,,
16844,6,0,6,,,,
1943,33,14,47,,,,
15405,20,42,62,,,,
6509,5,1,6,,,,
16766,1,0,1,,,,
7826,3,34,37,,,,
5492,8,9,17,,,,
11316,6,22,28,,,,
4193,15,21,36,,,,
15066,11,12,23,,,,
1809,83,16,99,,,,
12449,3,4,7,,,,
12118,12,8,20,,,,
15233,5,0,5,,,,
10602,2,4,6,,,,
8993,107,8,115,,,,
15149,12,5,17,,,,
6180,3,103,106,,,,
5721,10,0,10,,,,
7254,1,8,9,,,,
7863,11,6,17,,,,
466,4,5,9,,,,
3149,8,14,22,,,,
1634,5,13,18,,,,
3981,50,17,67,,,,
6391,7,10,17,,,,
8475,5,19,24,,,,
5786,38,20,58,,,,
547,23,11,34,,,,
12139,24,3,27,,,,
12733,4,0,4,,,,
11831,24,4,28,,,,
12516,7,34,41,,,,
9463,9,3,12,,,,
7850,5,23,28,,,,
2530,23,42,65,,,,
14055,5,8,13,,,,
3167,4,6,10,,,,
11583,10,19,29,,,,
13224,13,74,87,,,,
15255,2,13,15,,,,
11617,16,12,28,,,,
7392,4,17,21,,,,
15187,3,4,7,,,,
12847,5,0,5,,,,
1211,34,9,43,,,,
8276,4,21,25,,,,
15281,1,3,4,,,,
6003,4,5,9,,,,
619,13,3,16,,,,
13279,1,1,2,,,,
2474,12,2,14,,,,
4377,36,6,42,,,,
16360,1,0,1,,,,
5430,63,140,203,,,,
13675,1,4,5,,,,
9375,4,9,13,,,,
822,6,2,8,,,,
3742,3,3,6,,,,
6659,24,57,81,,,,
8222,48,5,53,,,,
12113,7,4,11,,,,
4520,7,34,41,,,,
8784,12,35,47,,,,
8785,37,44,81,,,,
1709,14,13,27,,,,
6497,22,26,48,,,,
9896,1,3,4,,,,
9137,4,3,7,,,,
6897,3,5,8,,,,
4977,2,4,6,,,,
15466,20,4,24,,,,
9728,12,16,28,,,,
10991,5,3,8,,,,
9002,3,12,15,,,,
10121,3,10,13,,,,
12062,7,17,24,,,,
16894,12,0,12,,,,
8582,9,11,20,,,,
11115,6,3,9,,,,
10348,6,1,7,,,,
6863,6,4,10,,,,
8798,2,3,5,,,,
16856,10,0,10,,,,
4173,4,8,12,,,,
7990,4,2,6,,,,
3824,2,1,3,,,,
14501,8,6,14,,,,
3727,8,8,16,,,,
7877,2,9,11,,,,
5275,3,25,28,,,,
3450,31,4,35,,,,
14859,3,3,6,,,,
14097,3,3,6,,,,
5683,3,0,3,,,,
15521,3,6,9,,,,
1127,17,2,19,,,,
11597,8,13,21,,,,
6179,49,7,56,,,,
13065,3,0,3,,,,
4797,24,14,38,,,,
11806,25,6,31,,,,
4555,55,71,126,,,,
1893,43,1,44,,,,
12908,1,7,8,,,,
12191,13,6,19,,,,
4655,13,11,24,,,,
16910,4,0,4,,,,
12299,5,5,10,,,,
8779,26,31,57,,,,
17505,3,4,7,,,,
3744,1,6,7,,,,
1158,43,2,45,,,,
10710,5,0,5,,,,
4044,1,0,1,,,,
601,1,2,3,,,,
4231,4,30,34,,,,
4360,4,5,9,,,,
16034,9,12,21,,,,
6661,10,7,17,,,,
8974,72,18,90,,,,
11167,5,0,5,,,,
16037,15,37,52,,,,
5164,7,7,14,,,,
16075,18,23,41,,,,
11063,4,4,8,,,,
14970,11,16,27,,,,
1209,6,4,10,,,,
5177,1,11,12,,,,
11514,6,7,13,,,,
14570,22,4,26,,,,
16993,4,6,10,,,,
11728,8,64,72,,,,
3577,4,2,6,,,,
4608,9,9,18,,,,
63,128,85,213,,,,
4847,13,4,17,,,,
6531,86,41,127,,,,
17461,1,1,2,,,,
11944,4,16,20,,,,
11349,2,5,7,,,,
15541,5,40,45,,,,
14699,9,9,18,,,,
6005,1,2,3,,,,
10154,1,9,10,,,,
7059,27,18,45,,,,
7590,2,19,21,,,,
1402,11,22,33,,,,
11676,24,72,96,,,,
6777,19,6,25,,,,
10080,5,7,12,,,,
7211,4,57,61,,,,
15036,3,0,3,,,,
327,23,0,23,,,,
13074,3,23,26,,,,
3081,14,28,42,,,,
8282,35,20,55,,,,
4319,21,23,44,,,,
7203,13,2,15,,,,
4794,26,13,39,,,,
17695,3,0,3,,,,
14334,3,15,18,,,,
7460,1,1,2,,,,
9111,23,4,27,,,,
3256,78,26,104,,,,
10674,28,8,36,,,,
8173,106,4,110,,,,
6761,14,7,21,,,,
12802,20,14,34,,,,
7126,3,3,6,,,,
13114,7,1,8,,,,
11075,4,7,11,,,,
4321,17,9,26,,,,
10981,7,0,7,,,,
13221,12,16,28,,,,
6139,3,1,4,,,,
14324,11,0,11,,,,
10549,36,58,94,,,,
13720,3,43,46,,,,
5768,12,3,15,,,,
14751,2,0,2,,,,
5968,5,0,5,,,,
394,2,1,3,,,,
16016,18,33,51,,,,
16015,41,9,50,,,,
2311,28,15,43,,,,
2738,17,25,42,,,,
12495,29,35,64,,,,
4617,4,7,11,,,,
9582,7,11,18,,,,
4545,12,72,84,,,,
11528,3,0,3,,,,
9251,6,0,6,,,,
14849,6,4,10,,,,
7148,7,4,11,,,,
11067,3,5,8,,,,
2794,1,3,4,,,,
17028,13,2,15,,,,
16683,1,4,5,,,,
11905,12,13,25,,,,
7325,4,4,8,,,,
411,19,19,38,,,,
17338,10,1,11,,,,
6834,11,9,20,,,,
9747,18,23,41,,,,
5821,5,61,66,,,,
11014,15,18,33,,,,
1440,19,12,31,,,,
6174,70,33,103,,,,
7780,1,15,16,,,,
7432,1,7,8,,,,
16854,2,8,10,,,,
1646,10,2,12,,,,
1294,38,3,41,,,,
11946,35,5,40,,,,
17429,4,1,5,,,,
4370,20,32,52,,,,
4506,3,4,7,,,,
12443,7,24,31,,,,
4100,4,29,33,,,,
16785,1,1,2,,,,
10070,13,16,29,,,,
16351,10,26,36,,,,
4326,18,13,31,,,,
13822,9,7,16,,,,
2196,2,5,7,,,,
1679,18,93,111,,,,
7641,15,17,32,,,,
12432,52,52,104,,,,
13441,2,1,3,,,,
15067,5,3,8,,,,
10887,2,3,5,,,,
542,90,29,119,,,,
12637,9,0,9,,,,
4857,2,1,3,,,,
5261,29,22,51,,,,
10651,3,0,3,,,,
4593,18,1,19,,,,
15560,5,4,9,,,,
5603,2,14,16,,,,
15404,5,16,21,,,,
4765,29,12,41,,,,
6936,3,8,11,,,,
8479,20,14,34,,,,
4834,2,4,6,,,,
2400,36,32,68,,,,
16462,10,4,14,,,,
7420,7,5,12,,,,
15478,8,12,20,,,,
12404,4,1,5,,,,
10409,1,4,5,,,,
3813,1,11,12,,,,
16490,3,15,18,,,,
7409,2,4,6,,,,
3479,20,15,35,,,,
11081,13,0,13,,,,
16547,1,4,5,,,,
2739,2,48,50,,,,
10338,4,6,10,,,,
4397,77,40,117,,,,
525,2,0,2,,,,
6769,6,26,32,,,,
1605,131,128,259,,,,
2710,6,9,15,,,,
15685,1,9,10,,,,
10032,72,14,86,,,,
2417,1,113,114,,,,
10900,12,3,15,,,,
7903,19,2,21,,,,
17563,4,7,11,,,,
13885,1,0,1,,,,
701,16,441,457,,,,
10,8,34,42,,,,
727,49,67,116,,,,
11695,5,36,41,,,,
13329,16,0,16,,,,
15769,1,0,1,,,,
3245,6,43,49,,,,
2006,139,8,147,,,,
3059,17,1,18,,,,
15072,1,6,7,,,,
8857,1,2,3,,,,
14710,4,12,16,,,,
10984,13,2,15,,,,
14328,3,1,4,,,,
4484,6,46,52,,,,
11273,6,0,6,,,,
9898,6,15,21,,,,
5929,8,0,8,,,,
140,215,79,294,,,,
8397,8,0,8,,,,
742,96,37,133,,,,
4776,4,36,40,,,,
6709,9,0,9,,,,
16740,2,2,4,,,,
6714,3,18,21,,,,
16752,3,3,6,,,,
7578,3,2,5,,,,
9882,3,3,6,,,,
6913,13,35,48,,,,
11940,22,13,35,,,,
7954,14,14,28,,,,
16391,12,2,14,,,,
2568,10,23,33,,,,
12271,2,7,9,,,,
14689,10,8,18,,,,
16441,1,5,6,,,,
7306,7,4,11,,,,
5485,58,35,93,,,,
1681,26,38,64,,,,
13945,4,23,27,,,,
13672,10,1,11,,,,
12202,1,7,8,,,,
931,7,3,10,,,,
5894,62,28,90,,,,
10037,6,29,35,,,,
13630,5,5,10,,,,
15846,1,4,5,,,,
14396,13,3,16,,,,
3878,75,4,79,,,,
11127,2,0,2,,,,
6393,1,2,3,,,,
9108,24,11,35,,,,
7662,37,14,51,,,,
13553,7,4,11,,,,
13899,4,0,4,,,,
13062,1,12,13,,,,
16114,5,7,12,,,,
13135,4,21,25,,,,
13887,10,12,22,,,,
8684,23,12,35,,,,
4723,36,22,58,,,,
5349,42,157,199,,,,
5224,4,21,25,,,,
15192,4,2,6,,,,
8321,1,32,33,,,,
15977,5,19,24,,,,
310,6,17,23,,,,
5248,10,38,48,,,,
250,10,4,14,,,,
13081,16,16,32,,,,
10510,50,0,50,,,,
15637,4,1,5,,,,
23,5,9,14,,,,
9500,8,5,13,,,,
2758,12,4,16,,,,
9807,4,24,28,,,,
12515,9,11,20,,,,
1095,10,1,11,,,,
482,18,0,18,,,,
3758,2,3,5,,,,
9008,15,3,18,,,,
9327,15,6,21,,,,
380,29,6,35,,,,
7474,4,14,18,,,,
13225,1,4,5,,,,
11747,6,3,9,,,,
17149,1,6,7,,,,
11709,7,14,21,,,,
14256,6,3,9,,,,
6472,5,17,22,,,,
3601,2,5,7,,,,
4303,13,11,24,,,,
5448,54,69,123,,,,
9164,10,0,10,,,,
9696,2,2,4,,,,
3688,6,17,23,,,,
193,26,70,96,,,,
16770,6,15,21,,,,
13312,4,4,8,,,,
2804,4,1,5,,,,
16048,6,33,39,,,,
3931,24,7,31,,,,
13382,10,6,16,,,,
5953,22,2,24,,,,
7768,94,46,140,,,,
12009,27,3,30,,,,
3904,5,61,66,,,,
9548,27,10,37,,,,
10562,1,24,25,,,,
15983,3,2,5,,,,
14811,3,6,9,,,,
2206,30,3,33,,,,
12752,5,2,7,,,,
11153,7,2,9,,,,
3591,6,22,28,,,,
12112,7,4,11,,,,
4505,6,1,7,,,,
16589,6,20,26,,,,
17510,2,4,6,,,,
6975,7,6,13,,,,
3484,2,8,10,,,,
15071,4,12,16,,,,
1249,70,25,95,,,,
2194,21,2,23,,,,
15505,1,44,45,,,,
12661,36,10,46,,,,
1824,2,1,3,,,,
16977,9,5,14,,,,
2047,2,2,4,,,,
9421,1,5,6,,,,
11144,7,1,8,,,,
2740,5,3,8,,,,
11620,7,9,16,,,,
4164,24,23,47,,,,
17890,8,1,9,,,,
2052,11,1,12,,,,
12472,4,0,4,,,,
14446,26,19,45,,,,
2127,8,20,28,,,,
14291,3,4,7,,,,
9713,2,15,17,,,,
12837,8,1,9,,,,
1308,15,35,50,,,,
16387,9,4,13,,,,
11188,72,14,86,,,,
12638,12,3,15,,,,
1050,21,34,55,,,,
912,9,2,11,,,,
6848,36,25,61,,,,
1967,21,2,23,,,,
9253,1,0,1,,,,
744,93,45,138,,,,
9351,8,35,43,,,,
5980,6,1,7,,,,
4580,42,31,73,,,,
17571,2,4,6,,,,
16301,2,22,24,,,,
1606,23,31,54,,,,
8811,4,0,4,,,,
12181,6,11,17,,,,
14623,35,6,41,,,,
827,41,145,186,,,,
14775,1,9,10,,,,
10118,11,16,27,,,,
1099,26,4,30,,,,
11983,1,8,9,,,,
11476,6,1,7,,,,
10309,7,13,20,,,,
8152,44,30,74,,,,
5880,5,1,6,,,,
5838,36,3,39,,,,
6158,14,20,34,,,,
13399,1,38,39,,,,
16137,17,5,22,,,,
993,16,11,27,,,,
4217,26,27,53,,,,
14785,8,15,23,,,,
15393,26,8,34,,,,
10590,38,0,38,,,,
11659,9,4,13,,,,
9011,4,22,26,,,,
10610,4,0,4,,,,
3289,35,125,160,,,,
8079,1,33,34,,,,
8594,5,9,14,,,,
11219,7,7,14,,,,
17251,1,1,2,,,,
11929,8,28,36,,,,
10661,2,6,8,,,,
8207,16,5,21,,,,
5789,2,7,9,,,,
1851,44,136,180,,,,
640,89,89,178,,,,
2184,3,0,3,,,,
271,8,7,15,,,,
13120,2,4,6,,,,
14860,5,19,24,,,,
6790,32,36,68,,,,
12065,9,10,19,,,,
15895,5,2,7,,,,
2211,51,3,54,,,,
6953,1,11,12,,,,
10729,4,28,32,,,,
16241,1,2,3,,,,
8356,3,0,3,,,,
15602,2,1,3,,,,
10845,1,2,3,,,,
11468,5,2,7,,,,
10803,5,7,12,,,,
1622,2,24,26,,,,
3499,31,5,36,,,,
8621,11,14,25,,,,
16817,3,3,6,,,,
2186,14,3,17,,,,
12754,15,8,23,,,,
15954,7,3,10,,,,
9383,9,1,10,,,,
8444,17,2,19,,,,
5027,48,4,52,,,,
14799,6,13,19,,,,
8636,3,2,5,,,,
3528,14,6,20,,,,
8280,9,1,10,,,,
15207,4,0,4,,,,
8687,38,16,54,,,,
11603,6,0,6,,,,
11117,3,0,3,,,,
13172,44,39,83,,,,
7178,43,8,51,,,,
6886,17,3,20,,,,
7116,22,1,23,,,,
12380,1,1,2,,,,
17824,2,3,5,,,,
11028,1,1,2,,,,
14085,8,9,17,,,,
12042,6,2,8,,,,
1058,2,9,11,,,,
4249,7,4,11,,,,
4531,33,67,100,,,,
10931,6,3,9,,,,
14106,17,2,19,,,,
3686,3,4,7,,,,
14662,14,12,26,,,,
3432,17,25,42,,,,
11727,14,14,28,,,,
8454,1,0,1,,,,
7159,10,2,12,,,,
16688,29,4,33,,,,
6240,10,6,16,,,,
3886,2,51,53,,,,
15710,7,5,12,,,,
3826,4,14,18,,,,
5440,40,126,166,,,,
15144,3,12,15,,,,
6285,9,6,15,,,,
7179,4,4,8,,,,
7345,8,0,8,,,,
13220,19,28,47,,,,
5406,76,114,190,,,,
1877,10,34,44,,,,
8083,9,0,9,,,,
11111,5,4,9,,,,
536,2,11,13,,,,
2220,6,6,12,,,,
6135,34,20,54,,,,
12447,8,8,16,,,,
2028,1,0,1,,,,
11020,12,0,12,,,,
16148,2,0,2,,,,
9109,14,10,24,,,,
4302,28,11,39,,,,
6223,13,50,63,,,,
6621,22,8,30,,,,
809,21,29,50,,,,
1117,10,0,10,,,,
10699,28,59,87,,,,
326,2,7,9,,,,
3951,6,19,25,,,,
1528,7,3,10,,,,
11218,13,1,14,,,,
11156,2,2,4,,,,
6275,6,26,32,,,,
12597,1,3,4,,,,
1686,43,5,48,,,,
3269,11,1,12,,,,
3726,5,20,25,,,,
13131,1,21,22,,,,
758,21,9,30,,,,
1581,36,106,142,,,,
7231,8,19,27,,,,
3169,92,45,137,,,,
1503,14,28,42,,,,
10312,2,1,3,,,,
9184,32,36,68,,,,
5654,4,10,14,,,,
6041,15,6,21,,,,
1900,88,36,124,,,,
892,44,30,74,,,,
17623,1,0,1,,,,
617,8,32,40,,,,
2955,26,3,29,,,,
826,10,1,11,,,,
11621,25,7,32,,,,
7010,2,1,3,,,,
16251,10,8,18,,,,
16026,33,28,61,,,,
14391,7,5,12,,,,
13183,34,46,80,,,,
9615,3,11,14,,,,
340,6,10,16,,,,
3388,7,2,9,,,,
984,2,21,23,,,,
16963,14,1,15,,,,
9725,6,27,33,,,,
9526,37,0,37,,,,
1499,4,1,5,,,,
15060,11,13,24,,,,
1069,50,108,158,,,,
3377,5,20,25,,,,
5113,4,3,7,,,,
6558,3,1,4,,,,
13788,6,4,10,,,,
1647,55,34,89,,,,
8037,1,0,1,,,,
3639,3,3,6,,,,
5323,3,18,21,,,,
4375,20,1,21,,,,
1355,36,37,73,,,,
10724,10,8,18,,,,
3838,1,0,1,,,,
10732,3,1,4,,,,
4729,82,5,87,,,,
5860,4,27,31,,,,
16924,5,29,34,,,,
5459,209,2,211,,,,
1925,19,3,22,,,,
12810,26,3,29,,,,
6164,4,9,13,,,,
8348,6,2,8,,,,
12228,11,14,25,,,,
524,2,0,2,,,,
15273,1,0,1,,,,
6788,50,15,65,,,,
16497,3,0,3,,,,
3604,1,18,19,,,,
15579,2,0,2,,,,
8375,4,0,4,,,,
13192,43,1,44,,,,
11903,10,19,29,,,,
10010,34,9,43,,,,
1543,2,13,15,,,,
6564,7,27,34,,,,
10784,19,1,20,,,,
8686,6,23,29,,,,
8539,68,30,98,,,,
9208,4,7,11,,,,
5613,19,14,33,,,,
6115,3,0,3,,,,
12635,11,5,16,,,,
803,34,160,194,,,,
2884,3,20,23,,,,
10285,2,10,12,,,,
9677,18,51,69,,,,
11880,9,4,13,,,,
14209,10,37,47,,,,
12440,16,8,24,,,,
11078,5,3,8,,,,
14129,7,1,8,,,,
4001,32,12,44,,,,
4378,3,1,4,,,,
15143,3,4,7,,,,
5400,139,39,178,,,,
9323,40,2,42,,,,
5090,43,9,52,,,,
8014,4,30,34,,,,
11767,3,46,49,,,,
5257,28,4,32,,,,
874,16,38,54,,,,
7964,7,10,17,,,,
5007,2,0,2,,,,
10951,11,10,21,,,,
10412,5,1,6,,,,
570,3,12,15,,,,
16505,3,0,3,,,,
17358,3,0,3,,,,
8883,1,2,3,,,,
2707,3,0,3,,,,
5195,18,23,41,,,,
10833,8,13,21,,,,
15669,15,2,17,,,,
8992,6,44,50,,,,
15430,24,8,32,,,,
10271,9,1,10,,,,
7563,20,12,32,,,,
15178,8,2,10,,,,
5650,3,1,4,,,,
1872,8,1,9,,,,
16244,1,1,2,,,,
6,3,6,9,,,,
2660,49,4,53,,,,
2536,15,5,20,,,,
17636,7,5,12,,,,
350,17,12,29,,,,
7529,62,46,108,,,,
2918,19,60,79,,,,
7022,4,3,7,,,,
7898,2,20,22,,,,
3107,11,32,43,,,,
6244,11,19,30,,,,
750,88,4,92,,,,
7899,63,2,65,,,,
13787,1,7,8,,,,
13475,2,12,14,,,,
3706,36,2,38,,,,
10913,6,29,35,,,,
16405,44,5,49,,,,
477,5,3,8,,,,
12152,3,9,12,,,,
16989,3,2,5,,,,
4984,5,8,13,,,,
9183,5,0,5,,,,
3957,13,164,177,,,,
2255,6,8,14,,,,
4029,12,8,20,,,,
4812,5,39,44,,,,
13876,9,1,10,,,,
3090,6,0,6,,,,
11197,17,10,27,,,,
7388,3,32,35,,,,
15969,1,3,4,,,,
16853,2,11,13,,,,
9712,12,3,15,,,,
4697,49,20,69,,,,
10930,17,8,25,,,,
2236,3,11,14,,,,
13484,2,7,9,,,,
2732,22,12,34,,,,
3735,13,29,42,,,,
10794,41,3,44,,,,
16709,2,13,15,,,,
3881,9,90,99,,,,
13527,8,0,8,,,,
17469,3,3,6,,,,
14824,11,11,22,,,,
11179,5,2,7,,,,
7758,9,7,16,,,,
2894,2,44,46,,,,
9522,4,10,14,,,,
12260,21,17,38,,,,
8453,8,6,14,,,,
17122,5,22,27,,,,
3872,3,8,11,,,,
4559,30,6,36,,,,
10754,7,7,14,,,,
13273,1,3,4,,,,
3092,9,5,14,,,,
9992,6,92,98,,,,
14582,1,0,1,,,,
541,102,3,105,,,,
13356,8,1,9,,,,
8809,1,0,1,,,,
12905,2,1,3,,,,
6084,5,0,5,,,,
2044,26,6,32,,,,
3679,5,15,20,,,,
9452,2,2,4,,,,
4175,61,1,62,,,,
16912,2,0,2,,,,
513,3,6,9,,,,
8651,44,3,47,,,,
4240,4,6,10,,,,
3002,8,5,13,,,,
12033,5,16,21,,,,
3074,1,2,3,,,,
682,193,32,225,,,,
12801,1,2,3,,,,
9870,29,2,31,,,,
5843,11,27,38,,,,
14524,10,2,12,,,,
3697,3,10,13,,,,
8996,43,46,89,,,,
15068,4,0,4,,,,
1677,126,103,229,,,,
7006,4,4,8,,,,
1185,12,6,18,,,,
10211,23,6,29,,,,
16615,33,9,42,,,,
2441,29,115,144,,,,
11675,9,68,77,,,,
11262,1,0,1,,,,
15092,4,14,18,,,,
8977,8,3,11,,,,
15312,17,4,21,,,,
13417,6,0,6,,,,
3999,21,7,28,,,,
15049,5,9,14,,,,
5498,208,1,209,,,,
12970,4,27,31,,,,
2696,34,98,132,,,,
7948,35,5,40,,,,
2348,194,89,283,,,,
13554,19,1,20,,,,
14576,49,6,55,,,,
6583,31,17,48,,,,
1664,3,416,419,,,,
2062,2,0,2,,,,
14934,7,2,9,,,,
5282,3,3,6,,,,
13175,7,57,64,,,,
907,1,17,18,,,,
12339,5,18,23,,,,
14992,4,19,23,,,,
15641,7,19,26,,,,
11203,21,4,25,,,,
8199,19,74,93,,,,
9851,27,21,48,,,,
11790,92,4,96,,,,
10353,1,12,13,,,,
7175,7,0,7,,,,
6292,18,100,118,,,,
10457,5,0,5,,,,
10005,1,28,29,,,,
14817,6,0,6,,,,
6682,71,103,174,,,,
1169,2,3,5,,,,
11238,4,26,30,,,,
7766,2,32,34,,,,
17725,7,0,7,,,,
1252,8,14,22,,,,
6919,6,4,10,,,,
550,86,13,99,,,,
4158,10,21,31,,,,
4263,88,72,160,,,,
2823,1,0,1,,,,
2476,2,6,8,,,,
164,22,533,555,,,,
8882,3,17,20,,,,
3231,5,22,27,,,,
14770,3,9,12,,,,
16984,10,1,11,,,,
9647,11,5,16,,,,
15392,8,13,21,,,,
8371,11,8,19,,,,
4479,7,0,7,,,,
9165,3,8,11,,,,
9226,1,9,10,,,,
11299,7,0,7,,,,
9299,5,9,14,,,,
2546,11,2,13,,,,
838,8,14,22,,,,
7765,15,12,27,,,,
12853,3,2,5,,,,
13041,8,2,10,,,,
11397,1,3,4,,,,
8370,11,1,12,,,,
2488,28,15,43,,,,
14581,2,0,2,,,,
16333,10,0,10,,,,
996,41,16,57,,,,
2181,11,1,12,,,,
7806,1,2,3,,,,
15037,8,3,11,,,,
3097,35,4,39,,,,
14417,1,1,2,,,,
2669,9,1,10,,,,
7343,11,5,16,,,,
138,6,24,30,,,,
11132,4,5,9,,,,
3807,1,18,19,,,,
6625,1,12,13,,,,
10888,5,11,16,,,,
12171,3,4,7,,,,
15996,20,12,32,,,,
6338,11,33,44,,,,
8392,6,1,7,,,,
5648,3,1,4,,,,
2597,19,5,24,,,,
12496,5,16,21,,,,
7160,3,3,6,,,,
14345,1,2,3,,,,
5188,12,0,12,,,,
17726,1,2,3,,,,
1914,46,52,98,,,,
7381,25,2,27,,,,
3456,9,5,14,,,,
14381,2,11,13,,,,
3948,84,100,184,,,,
17677,2,1,3,,,,
10030,4,6,10,,,,
5220,10,1,11,,,,
7845,14,7,21,,,,
9204,12,1,13,,,,
15675,7,0,7,,,,
4679,4,21,25,,,,
10000,3,9,12,,,,
12016,43,93,136,,,,
13567,12,5,17,,,,
15471,1,10,11,,,,
3684,14,10,24,,,,
10175,32,6,38,,,,
10416,3,3,6,,,,
2964,29,28,57,,,,
9539,13,13,26,,,,
1350,6,33,39,,,,
2637,45,67,112,,,,
8455,5,21,26,,,,
4127,27,17,44,,,,
10182,2,8,10,,,,
5109,19,0,19,,,,
16920,9,4,13,,,,
4439,20,8,28,,,,
12193,1,0,1,,,,
13510,3,1,4,,,,
702,6,130,136,,,,
13619,7,11,18,,,,
4074,4,42,46,,,,
2489,8,3,11,,,,
15278,1,5,6,,,,
12240,1,3,4,,,,
15622,1,1,2,,,,
4177,16,2,18,,,,
1163,2,1,3,,,,
4626,7,8,15,,,,
6784,12,8,20,,,,
6758,34,132,166,,,,
3701,9,87,96,,,,
14911,7,5,12,,,,
6473,12,3,15,,,,
7030,2,10,12,,,,
8607,9,27,36,,,,
10343,3,2,5,,,,
5924,4,2,6,,,,
8820,2,6,8,,,,
8164,52,53,105,,,,
3611,6,10,16,,,,
504,7,35,42,,,,
6027,5,15,20,,,,
13678,7,4,11,,,,
7872,115,30,145,,,,
5823,10,1,11,,,,
15553,1,18,19,,,,
16556,9,0,9,,,,
13616,39,6,45,,,,
16313,5,3,8,,,,
4128,10,50,60,,,,
16961,3,5,8,,,,
1327,22,16,38,,,,
10620,7,1,8,,,,
9795,3,10,13,,,,
7287,23,35,58,,,,
7141,73,104,177,,,,
15514,3,14,17,,,,
8106,2,4,6,,,,
10453,3,0,3,,,,
16981,3,7,10,,,,
12273,10,2,12,,,,
7296,2,3,5,,,,
1159,14,12,26,,,,
10206,6,13,19,,,,
27,1,33,34,,,,
13953,6,9,15,,,,
14117,5,1,6,,,,
10531,11,64,75,,,,
7943,2,30,32,,,,
1028,7,1,8,,,,
13218,13,5,18,,,,
2200,4,4,8,,,,
3862,1,29,30,,,,
10430,1,15,16,,,,
14565,18,13,31,,,,
13,9,0,9,,,,
1934,16,16,32,,,,
5404,5,188,193,,,,
14961,13,14,27,,,,
1552,53,46,99,,,,
15540,1,34,35,,,,
4754,3,18,21,,,,
7894,52,42,94,,,,
9634,5,4,9,,,,
8190,29,33,62,,,,
8281,6,30,36,,,,
8006,4,3,7,,,,
3442,7,11,18,,,,
5067,7,17,24,,,,
9439,3,15,18,,,,
15172,7,11,18,,,,
12167,7,4,11,,,,
3551,30,7,37,,,,
5539,9,6,15,,,,
13200,3,69,72,,,,
11502,2,20,22,,,,
15225,2,2,4,,,,
3624,13,3,16,,,,
372,7,17,24,,,,
3526,2,8,10,,,,
10444,13,13,26,,,,
3172,10,42,52,,,,
12953,7,4,11,,,,
11159,8,7,15,,,,
12386,7,13,20,,,,
1846,349,44,393,,,,
11185,41,3,44,,,,
7412,2,20,22,,,,
5352,1,210,211,,,,
791,26,14,40,,,,
2223,30,3,33,,,,
17666,2,0,2,,,,
316,6,2,8,,,,
16372,4,14,18,,,,
1187,25,1,26,,,,
5298,19,15,34,,,,
2358,25,52,77,,,,
522,12,4,16,,,,
3254,33,26,59,,,,
15353,2,7,9,,,,
1436,3,1,4,,,,
7560,7,10,17,,,,
15511,13,3,16,,,,
1195,15,8,23,,,,
15218,4,13,17,,,,
6642,68,0,68,,,,
1316,36,5,41,,,,
455,14,36,50,,,,
5859,17,10,27,,,,
5335,5,7,12,,,,
9762,31,4,35,,,,
4371,46,18,64,,,,
14216,15,7,22,,,,
1567,20,27,47,,,,
99,24,52,76,,,,
13051,45,44,89,,,,
7158,8,25,33,,,,
12945,6,0,6,,,,
15682,2,1,3,,,,
12599,23,6,29,,,,
12487,4,43,47,,,,
5212,10,6,16,,,,
8300,62,12,74,,,,
9711,2,3,5,,,,
4869,6,32,38,,,,
15304,26,5,31,,,,
16636,14,6,20,,,,
11526,7,4,11,,,,
15864,15,5,20,,,,
624,57,21,78,,,,
13741,8,9,17,,,,
13171,10,49,59,,,,
14491,5,16,21,,,,
7111,9,7,16,,,,
17154,6,11,17,,,,
15077,2,13,15,,,,
6759,10,18,28,,,,
7760,8,5,13,,,,
1917,32,14,46,,,,
8204,27,21,48,,,,
15994,46,18,64,,,,
5070,11,13,24,,,,
7956,5,10,15,,,,
7303,4,29,33,,,,
6878,7,3,10,,,,
8184,3,4,7,,,,
16074,3,18,21,,,,
10893,3,1,4,,,,
3647,18,0,18,,,,
6763,28,14,42,,,,
7222,21,5,26,,,,
6024,3,4,7,,,,
16385,9,1,10,,,,
12241,14,0,14,,,,
5942,3,4,7,,,,
4775,5,34,39,,,,
7484,16,2,18,,,,
15945,3,4,7,,,,
7217,4,7,11,,,,
10592,7,2,9,,,,
13779,11,0,11,,,,
4424,10,10,20,,,,
15963,2,7,9,,,,
2810,12,19,31,,,,
243,20,6,26,,,,
5234,47,0,47,,,,
9698,1,1,2,,,,
2237,37,32,69,,,,
15358,1,48,49,,,,
6010,25,39,64,,,,
13861,6,1,7,,,,
11632,22,14,36,,,,
771,40,26,66,,,,
2139,2,6,8,,,,
16799,1,0,1,,,,
15258,7,2,9,,,,
15929,1,1,2,,,,
14597,12,10,22,,,,
13267,2,1,3,,,,
4917,1,1,2,,,,
5328,2,10,12,,,,
14234,3,3,6,,,,
14038,8,2,10,,,,
1984,12,6,18,,,,
7679,4,0,4,,,,
17606,1,5,6,,,,
10264,133,12,145,,,,
8999,10,34,44,,,,
12977,15,1,16,,,,
15843,2,26,28,,,,
15851,1,7,8,,,,
885,8,2,10,,,,
12596,1,0,1,,,,
5742,10,0,10,,,,
13889,11,16,27,,,,
15944,1,4,5,,,,
3298,70,25,95,,,,
5308,2,28,30,,,,
4454,37,6,43,,,,
2819,1,15,16,,,,
3971,18,37,55,,,,
1269,2,9,11,,,,
17491,1,8,9,,,,
17885,3,2,5,,,,
3204,19,1,20,,,,
5122,3,16,19,,,,
8062,15,0,15,,,,
13825,4,0,4,,,,
7813,44,1,45,,,,
12034,2,12,14,,,,
17540,2,0,2,,,,
236,7,22,29,,,,
3943,12,17,29,,,,
10941,7,1,8,,,,
15382,10,26,36,,,,
9396,16,40,56,,,,
5735,21,26,47,,,,
16528,1,5,6,,,,
460,2,4,6,,,,
17281,11,11,22,,,,
2573,21,14,35,,,,
9591,11,3,14,,,,
14940,3,1,4,,,,
12573,4,0,4,,,,
516,1,4,5,,,,
11166,24,26,50,,,,
7798,1,6,7,,,,
16560,2,1,3,,,,
2883,38,3,41,,,,
1638,25,35,60,,,,
12716,2,20,22,,,,
9424,13,31,44,,,,
4204,101,13,114,,,,
13575,17,7,24,,,,
14676,2,0,2,,,,
1916,6,11,17,,,,
15129,30,4,34,,,,
15100,13,5,18,,,,
3956,4,2,6,,,,
15800,7,6,13,,,,
11586,1,5,6,,,,
12817,4,19,23,,,,
14211,23,36,59,,,,
15568,4,5,9,,,,
5385,40,122,162,,,,
7612,7,3,10,,,,
15611,2,5,7,,,,
80,7,24,31,,,,
14418,13,2,15,,,,
7577,7,22,29,,,,
12991,27,7,34,,,,
5371,105,49,154,,,,
13679,2,6,8,,,,
7611,18,0,18,,,,
3163,2,9,11,,,,
15479,1,0,1,,,,
8073,6,3,9,,,,
4471,32,89,121,,,,
3165,19,10,29,,,,
3215,13,13,26,,,,
6352,5,25,30,,,,
16009,24,0,24,,,,
11638,18,0,18,,,,
13174,69,29,98,,,,
13240,46,7,53,,,,
4715,61,5,66,,,,
3698,1,0,1,,,,
3907,296,49,345,,,,
8250,2,14,16,,,,
1740,1,26,27,,,,
9918,2,5,7,,,,
14002,4,0,4,,,,
4150,3,42,45,,,,
1387,166,2,168,,,,
5174,7,0,7,,,,
8412,1,4,5,,,,
11267,20,17,37,,,,
16426,3,3,6,,,,
5300,21,11,32,,,,
4607,21,14,35,,,,
7838,6,41,47,,,,
14571,25,9,34,,,,
599,2,0,2,,,,
14029,2,9,11,,,,
10197,16,6,22,,,,
5704,1,3,4,,,,
13551,6,9,15,,,,
2524,1,42,43,,,,
9490,2,2,4,,,,
3665,47,81,128,,,,
11101,9,0,9,,,,
8963,14,26,40,,,,
10518,30,8,38,,,,
9028,7,6,13,,,,
10760,2,2,4,,,,
16402,21,18,39,,,,
2330,28,37,65,,,,
8139,16,35,51,,,,
6026,15,11,26,,,,
658,26,93,119,,,,
4745,13,0,13,,,,
8048,8,7,15,,,,
16666,13,0,13,,,,
1278,16,30,46,,,,
17632,2,2,4,,,,
458,37,6,43,,,,
6046,88,17,105,,,,
15595,6,27,33,,,,
3148,25,6,31,,,,
12058,2,24,26,,,,
13331,9,19,28,,,,
11823,11,15,26,,,,
10122,3,4,7,,,,
14039,6,3,9,,,,
10101,14,71,85,,,,
7342,7,6,13,,,,
16096,2,16,18,,,,
1558,2,19,21,,,,
17550,2,0,2,,,,
3585,1,29,30,,,,
561,47,7,54,,,,
11496,19,10,29,,,,
11726,39,4,43,,,,
14439,45,7,52,,,,
12056,7,11,18,,,,
7400,1,9,10,,,,
1948,12,22,34,,,,
5200,26,1,27,,,,
13750,2,11,13,,,,
11334,44,127,171,,,,
1303,6,63,69,,,,
15378,37,1,38,,,,
120,180,34,214,,,,
2697,6,39,45,,,,
15263,8,0,8,,,,
4800,18,7,25,,,,
2440,32,54,86,,,,
6938,8,2,10,,,,
6862,1,14,15,,,,
3463,2,9,11,,,,
7127,5,13,18,,,,
7036,9,3,12,,,,
6909,18,49,67,,,,
11186,10,7,17,,,,
7398,2,1,3,,,,
2557,8,54,62,,,,
7310,3,0,3,,,,
6085,1,1,2,,,,
6515,2,18,20,,,,
4716,2,17,19,,,,
16827,4,10,14,,,,
3234,10,42,52,,,,
6613,2,24,26,,,,
6671,33,8,41,,,,
1361,172,35,207,,,,
438,7,3,10,,,,
6752,8,79,87,,,,
7238,6,5,11,,,,
12295,14,5,19,,,,
13933,1,7,8,,,,
15699,3,1,4,,,,
8704,1,24,25,,,,
2493,12,0,12,,,,
3228,6,32,38,,,,
2445,21,63,84,,,,
3980,17,58,75,,,,
95,47,26,73,,,,
6032,7,52,59,,,,
46,8,22,30,,,,
6191,60,2,62,,,,
905,34,11,45,,,,
12935,1,6,7,,,,
6342,11,6,17,,,,
8698,3,6,9,,,,
90,91,46,137,,,,
6976,3,1,4,,,,
5044,10,18,28,,,,
7413,2,11,13,,,,
15946,7,0,7,,,,
5081,3,4,7,,,,
12343,4,12,16,,,,
5116,3,3,6,,,,
7383,18,13,31,,,,
5342,16,114,130,,,,
5226,54,1,55,,,,
3139,1,3,4,,,,
3497,25,4,29,,,,
776,19,15,34,,,,
4090,53,5,58,,,,
9720,28,21,49,,,,
16143,2,1,3,,,,
4252,10,54,64,,,,
4402,30,1,31,,,,
11251,1,1,2,,,,
4584,4,0,4,,,,
934,22,10,32,,,,
4661,64,16,80,,,,
4827,1,13,14,,,,
13408,2,2,4,,,,
1174,57,14,71,,,,
4916,4,2,6,,,,
12372,3,4,7,,,,
15439,2,3,5,,,,
3853,13,68,81,,,,
8612,21,15,36,,,,
8078,3,0,3,,,,
4008,4,14,18,,,,
2418,7,21,28,,,,
17180,12,1,13,,,,
8049,18,4,22,,,,
2141,2,7,9,,,,
16693,25,13,38,,,,
1998,1,4,5,,,,
2454,12,18,30,,,,
2361,9,30,39,,,,
16665,7,0,7,,,,
2267,15,3,18,,,,
3032,3,8,11,,,,
2826,97,6,103,,,,
2596,23,17,40,,,,
9460,8,17,25,,,,
11551,5,2,7,,,,
2074,17,15,32,,,,
15179,6,9,15,,,,
1776,12,15,27,,,,
3809,11,4,15,,,,
5915,24,1,25,,,,
3682,9,4,13,,,,
2766,6,14,20,,,,
209,1,2,3,,,,
58,17,22,39,,,,
0,3,5,8,,,,
4440,6,10,16,,,,
384,1,26,27,,,,
307,15,0,15,,,,
16914,2,0,2,,,,
946,2,5,7,,,,
764,13,7,20,,,,
54,21,0,21,,,,
5713,1,0,1,,,,
1287,44,15,59,,,,
4553,7,34,41,,,,
1152,6,4,10,,,,
9683,42,8,50,,,,
5542,12,86,98,,,,
5033,1,5,6,,,,
8214,39,45,84,,,,
10425,28,0,28,,,,
1435,1,1,2,,,,
2609,44,48,92,,,,
2280,22,50,72,,,,
1551,3,280,283,,,,
16519,5,1,6,,,,
7407,8,17,25,,,,
4581,8,5,13,,,,
12381,13,1,14,,,,
9324,7,2,9,,,,
10543,18,10,28,,,,
10780,8,23,31,,,,
8102,5,0,5,,,,
3428,2,0,2,,,,
880,12,5,17,,,,
10860,2,1,3,,,,
16205,1,12,13,,,,
8314,25,1,26,,,,
10318,5,0,5,,,,
6075,1,10,11,,,,
5624,11,11,22,,,,
8782,20,39,59,,,,
10410,4,1,5,,,,
6871,9,3,12,,,,
10458,26,21,47,,,,
14516,6,10,16,,,,
8540,14,81,95,,,,
4385,34,89,123,,,,
6310,17,6,23,,,,
7883,21,7,28,,,,
10694,2,12,14,,,,
7618,14,18,32,,,,
9564,10,5,15,,,,
9861,22,11,33,,,,
12625,10,3,13,,,,
4221,36,2,38,,,,
10020,2,7,9,,,,
139,37,17,54,,,,
8345,17,11,28,,,,
9958,1,0,1,,,,
10073,4,11,15,,,,
12085,8,18,26,,,,
2864,16,59,75,,,,
2100,2,7,9,,,,
4037,9,20,29,,,,
10234,2,4,6,,,,
10173,26,15,41,,,,
9944,61,19,80,,,,
6726,67,48,115,,,,
3958,16,44,60,,,,
3970,32,18,50,,,,
16483,42,0,42,,,,
4779,5,1,6,,,,
9143,2,7,9,,,,
1458,2,0,2,,,,
3406,4,28,32,,,,
1297,29,19,48,,,,
4803,16,13,29,,,,
9785,2,13,15,,,,
13422,2,3,5,,,,
6507,28,52,80,,,,
9644,2,9,11,,,,
5577,5,17,22,,,,
5523,23,80,103,,,,
922,19,2,21,,,,
2949,39,38,77,,,,
15180,7,0,7,,,,
9561,18,7,25,,,,
17285,4,5,9,,,,
6317,37,10,47,,,,
6482,88,71,159,,,,
3131,1,1,2,,,,
14587,3,3,6,,,,
5938,21,29,50,,,,
10371,2,4,6,,,,
12543,25,45,70,,,,
2306,17,27,44,,,,
9116,2,15,17,,,,
12170,7,4,11,,,,
7490,129,8,137,,,,
9386,26,1,27,,,,
10498,9,24,33,,,,
1479,1,0,1,,,,
8302,2,3,5,,,,
1295,106,106,212,,,,
9227,8,9,17,,,,
9988,5,8,13,,,,
17645,2,7,9,,,,
2380,77,21,98,,,,
13731,3,21,24,,,,
559,34,40,74,,,,
8085,5,41,46,,,,
7621,4,16,20,,,,
4349,8,22,30,,,,
3769,6,21,27,,,,
1328,16,27,43,,,,
5745,11,5,16,,,,
2391,22,173,195,,,,
437,1,1,2,,,,
8856,9,11,20,,,,
3936,24,5,29,,,,
3515,12,3,15,,,,
7796,6,3,9,,,,
2098,3,4,7,,,,
4892,1,0,1,,,,
7707,124,3,127,,,,
673,13,28,41,,,,
13574,10,6,16,,,,
3804,18,0,18,,,,
3461,3,17,20,,,,
7686,3,7,10,,,,
4699,33,7,40,,,,
8081,1,0,1,,,,
1080,5,2,7,,,,
17106,1,3,4,,,,
8128,65,2,67,,,,
14503,1,10,11,,,,
8951,1,3,4,,,,
6147,11,19,30,,,,
7468,1,0,1,,,,
6359,2,0,2,,,,
7471,1,14,15,,,,
17599,7,2,9,,,,
5801,5,0,5,,,,
7512,5,22,27,,,,
13605,2,4,6,,,,
8754,6,5,11,,,,
16685,2,3,5,,,,
1738,59,50,109,,,,
13028,2,0,2,,,,
1024,5,7,12,,,,
355,8,8,16,,,,
14114,15,0,15,,,,
7597,15,15,30,,,,
2232,14,1,15,,,,
14264,7,3,10,,,,
11590,5,0,5,,,,
6575,3,11,14,,,,
1048,4,22,26,,,,
15240,27,4,31,,,,
4704,6,46,52,,,,
1148,2,26,28,,,,
1027,2,1,3,,,,
10775,3,4,7,,,,
3738,20,13,33,,,,
5223,5,70,75,,,,
2108,469,2,471,,,,
13303,1,2,3,,,,
14385,12,21,33,,,,
8230,43,20,63,,,,
8876,27,10,37,,,,
4897,6,5,11,,,,
13165,22,12,34,,,,
12036,3,1,4,,,,
3643,3,3,6,,,,
3667,18,17,35,,,,
12753,8,2,10,,,,
6015,13,1,14,,,,
14779,4,6,10,,,,
1114,10,8,18,,,,
1585,22,15,37,,,,
9621,12,5,17,,,,
12815,9,9,18,,,,
9629,3,13,16,,,,
10242,25,9,34,,,,
1223,20,26,46,,,,
166,19,300,319,,,,
11538,2,1,3,,,,
2410,15,27,42,,,,
1965,49,56,105,,,,
13550,11,9,20,,,,
14370,1,0,1,,,,
3978,7,43,50,,,,
1333,8,48,56,,,,
10491,9,2,11,,,,
4736,38,5,43,,,,
7769,37,5,42,,,,
6921,2,8,10,,,,
7121,15,6,21,,,,
3902,21,2,23,,,,
10919,1,9,10,,,,
14531,3,18,21,,,,
1092,10,2,12,,,,
12254,13,10,23,,,,
7394,89,12,101,,,,
15910,1,10,11,,,,
1089,5,4,9,,,,
3675,13,25,38,,,,
1170,3,7,10,,,,
1870,38,46,84,,,,
9154,5,0,5,,,,
1161,10,3,13,,,,
406,255,15,270,,,,
3967,12,65,77,,,,
12385,1,0,1,,,,
1464,30,25,55,,,,
12002,44,66,110,,,,
11971,7,7,14,,,,
1611,57,35,92,,,,
11996,19,13,32,,,,
5425,57,127,184,,,,
1608,10,174,184,,,,
3683,27,70,97,,,,
4490,12,14,26,,,,
12049,16,8,24,,,,
12019,2,7,9,,,,
6836,3,4,7,,,,
2965,29,7,36,,,,
8746,2,0,2,,,,
10798,6,3,9,,,,
10219,11,1,12,,,,
10880,4,9,13,,,,
12127,1,0,1,,,,
4310,49,16,65,,,,
4544,59,40,99,,,,
11012,1,3,4,,,,
8586,5,3,8,,,,
1132,9,7,16,,,,
14668,12,11,23,,,,
3866,19,18,37,,,,
11655,23,10,33,,,,
9547,36,20,56,,,,
17746,1,0,1,,,,
4726,12,13,25,,,,
6550,8,14,22,,,,
11777,11,1,12,,,,
3019,15,17,32,,,,
897,10,13,23,,,,
17394,1,3,4,,,,
11890,4,5,9,,,,
12387,2,0,2,,,,
2525,24,3,27,,,,
527,96,85,181,,,,
8789,26,70,96,,,,
5375,96,86,182,,,,
15288,1,4,5,,,,
5374,143,64,207,,,,
4290,37,21,58,,,,
15785,5,4,9,,,,
4952,1,1,2,,,,
11479,10,19,29,,,,
6987,4,4,8,,,,
14012,3,4,7,,,,
6192,2,8,10,,,,
1498,73,1,74,,,,
451,6,3,9,,,,
5919,7,14,21,,,,
9797,1,12,13,,,,
8850,2,14,16,,,,
1383,3,39,42,,,,
11516,12,0,12,,,,
6695,2,12,14,,,,
4166,21,26,47,,,,
10908,6,5,11,,,,
2705,2,5,7,,,,
17541,4,1,5,,,,
1671,16,27,43,,,,
6579,7,12,19,,,,
4347,54,121,175,,,,
10184,21,3,24,,,,
11018,2,4,6,,,,
3390,3,0,3,,,,
4986,7,45,52,,,,
4962,8,4,12,,,,
11224,8,7,15,,,,
11158,10,5,15,,,,
11130,10,3,13,,,,
3413,28,2,30,,,,
7675,2,15,17,,,,
1794,7,19,26,,,,
11671,24,23,47,,,,
299,31,76,107,,,,
5574,6,0,6,,,,
11021,1,4,5,,,,
7592,3,3,6,,,,
14271,2,6,8,,,,
7071,2,1,3,,,,
3491,2,0,2,,,,
9506,13,0,13,,,,
1035,2,48,50,,,,
2785,38,3,41,,,,
14622,6,0,6,,,,
15989,1,0,1,,,,
6148,32,9,41,,,,
4036,15,2,17,,,,
2506,8,2,10,,,,
7947,2,7,9,,,,
11626,27,2,29,,,,
3596,9,10,19,,,,
14094,1,7,8,,,,
5646,5,25,30,,,,
12748,10,1,11,,,,
1299,230,14,244,,,,
14033,1,2,3,,,,
10507,4,16,20,,,,
5700,14,9,23,,,,
435,4,5,9,,,,
12492,10,12,22,,,,
14159,8,3,11,,,,
15597,6,4,10,,,,
13905,2,11,13,,,,
14014,1,4,5,,,,
17340,4,11,15,,,,
16543,2,3,5,,,,
13984,17,1,18,,,,
7600,3,2,5,,,,
11634,5,46,51,,,,
13774,19,2,21,,,,
15081,1,3,4,,,,
11485,9,41,50,,,,
2303,82,1,83,,,,
10323,2,22,24,,,,
2414,1,6,7,,,,
2110,3,6,9,,,,
12213,2,2,4,,,,
14064,18,0,18,,,,
11325,116,11,127,,,,
837,20,1,21,,,,
13898,3,1,4,,,,
1667,21,13,34,,,,
926,16,37,53,,,,
13913,1,1,2,,,,
3079,2,4,6,,,,
6488,8,6,14,,,,
884,12,45,57,,,,
1323,16,12,28,,,,
4820,5,41,46,,,,
13826,6,0,6,,,,
2459,2,6,8,,,,
7367,9,2,11,,,,
13330,14,15,29,,,,
7648,13,9,22,,,,
4727,29,14,43,,,,
11217,2,0,2,,,,
16686,2,8,10,,,,
5412,70,113,183,,,,
10929,4,4,8,,,,
3493,1,3,4,,,,
3378,10,4,14,,,,
12566,22,6,28,,,,
10638,23,9,32,,,,
11667,6,6,12,,,,
11381,6,4,10,,,,
5289,26,10,36,,,,
13823,2,14,16,,,,
6126,2,0,2,,,,
10654,2,1,3,,,,
11447,1,3,4,,,,
11242,54,12,66,,,,
3859,2,39,41,,,,
15308,8,0,8,,,,
13862,6,3,9,,,,
13403,6,10,16,,,,
12764,6,0,6,,,,
9656,6,0,6,,,,
12663,15,16,31,,,,
11871,12,3,15,,,,
14562,72,15,87,,,,
5391,41,165,206,,,,
8895,2,8,10,,,,
13690,4,3,7,,,,
12190,2,2,4,,,,
11914,7,9,16,,,,
11503,22,29,51,,,,
7950,29,9,38,,,,
11070,46,3,49,,,,
14971,1,6,7,,,,
4702,11,26,37,,,,
8852,2,5,7,,,,
12504,24,4,28,,,,
6368,7,5,12,,,,
11934,17,1,18,,,,
11435,7,1,8,,,,
13249,11,0,11,,,,
3793,9,5,14,,,,
10770,4,4,8,,,,
13580,2,0,2,,,,
5536,12,2,14,,,,
13518,10,32,42,,,,
14502,8,14,22,,,,
13601,5,6,11,,,,
12322,6,2,8,,,,
6400,3,0,3,,,,
4653,2,19,21,,,,
11139,7,17,24,,,,
5242,11,15,26,,,,
695,141,61,202,,,,
17345,7,7,14,,,,
5779,4,0,4,,,,
12789,7,4,11,,,,
7382,7,13,20,,,,
2279,5,15,20,,,,
2490,12,53,65,,,,
5353,160,15,175,,,,
12337,7,29,36,,,,
6410,10,16,26,,,,
2500,4,12,16,,,,
475,2,0,2,,,,
222,3,4,7,,,,
1779,13,23,36,,,,
13840,2,3,5,,,,
11610,1,0,1,,,,
2496,6,6,12,,,,
3954,47,51,98,,,,
950,21,3,24,,,,
10469,2,28,30,,,,
12873,2,2,4,,,,
368,7,18,25,,,,
9892,60,1,61,,,,
12458,21,120,141,,,,
2083,4,4,8,,,,
13696,5,25,30,,,,
15756,3,0,3,,,,
9115,9,3,12,,,,
17629,2,5,7,,,,
1727,56,71,127,,,,
2491,1,72,73,,,,
16365,2,0,2,,,,
17467,1,17,18,,,,
2188,1,6,7,,,,
12296,8,19,27,,,,
4012,19,2,21,,,,
1118,19,4,23,,,,
11654,14,1,15,,,,
14661,4,0,4,,,,
14098,1,2,3,,,,
17730,14,3,17,,,,
17376,7,8,15,,,,
9290,3,3,6,,,,
7170,2,5,7,,,,
16841,2,0,2,,,,
15617,2,8,10,,,,
1246,8,2,10,,,,
2338,204,27,231,,,,
3803,3,5,8,,,,
5336,2,48,50,,,,
9622,10,7,17,,,,
6973,6,12,18,,,,
3649,3,3,6,,,,
11605,16,9,25,,,,
13547,6,16,22,,,,
1743,556,54,610,,,,
17017,8,6,14,,,,
12705,24,5,29,,,,
9652,3,27,30,,,,
50,13,6,19,,,,
5760,8,1,9,,,,
10636,21,22,43,,,,
1736,18,16,34,,,,
14275,4,2,6,,,,
15513,3,3,6,,,,
3660,67,52,119,,,,
10643,9,31,40,,,,
12786,1,4,5,,,,
14857,4,3,7,,,,
4198,13,66,79,,,,
3703,7,63,70,,,,
10499,19,47,66,,,,
2512,1,10,11,,,,
7599,2,12,14,,,,
6517,48,7,55,,,,
9602,2,4,6,,,,
4320,10,80,90,,,,
3880,6,13,19,,,,
9380,84,4,88,,,,
5016,22,53,75,,,,
7488,3,15,18,,,,
17397,1,5,6,,,,
6678,15,70,85,,,,
11805,15,4,19,,,,
12940,3,9,12,,,,
13302,6,2,8,,,,
12830,6,6,12,,,,
3855,14,36,50,,,,
11933,20,4,24,,,,
7870,8,9,17,,,,
6256,109,4,113,,,,
2780,10,17,27,,,,
6860,1,0,1,,,,
15803,1,0,1,,,,
5405,8,199,207,,,,
11795,12,5,17,,,,
1384,14,29,43,,,,
12131,4,7,11,,,,
14137,2,14,16,,,,
2013,4,0,4,,,,
7393,11,6,17,,,,
6720,4,3,7,,,,
1405,8,107,115,,,,
4301,12,32,44,,,,
3376,11,1,12,,,,
7699,21,13,34,,,,
3110,25,10,35,,,,
13059,6,18,24,,,,
17265,12,11,23,,,,
13670,6,2,8,,,,
6794,18,38,56,,,,
9423,10,3,13,,,,
10012,17,7,24,,,,
14681,2,5,7,,,,
7166,21,27,48,,,,
5598,5,45,50,,,,
12231,15,1,16,,,,
12617,8,39,47,,,,
9535,3,1,4,,,,
13624,8,23,31,,,,
4417,25,28,53,,,,
2937,18,68,86,,,,
6094,8,7,15,,,,
9239,15,2,17,,,,
5309,26,8,34,,,,
1735,48,20,68,,,,
17837,3,2,5,,,,
13238,2,25,27,,,,
5903,91,37,128,,,,
11039,9,9,18,,,,
16502,8,0,8,,,,
1245,8,4,12,,,,
12104,6,7,13,,,,
9071,117,47,164,,,,
8246,7,42,49,,,,
2577,20,11,31,,,,
13230,6,12,18,,,,
7570,16,10,26,,,,
1213,11,46,57,,,,
8952,3,4,7,,,,
8051,4,4,8,,,,
9607,5,8,13,,,,
10337,1,13,14,,,,
13537,24,8,32,,,,
12577,8,20,28,,,,
13480,6,1,7,,,,
15165,1,7,8,,,,
1762,44,75,119,,,,
14758,4,0,4,,,,
6854,20,1,21,,,,
6859,5,3,8,,,,
9357,40,0,40,,,,
2189,1,10,11,,,,
888,5,5,10,,,,
12703,3,3,6,,,,
5520,154,31,185,,,,
14488,1,24,25,,,,
89,38,231,269,,,,
2834,4,9,13,,,,
10245,13,9,22,,,,
1357,3,36,39,,,,
7069,13,6,19,,,,
16730,3,2,5,,,,
16486,2,4,6,,,,
8435,35,12,47,,,,
10915,10,15,25,,,,
1379,28,9,37,,,,
5978,1,1,2,,,,
12612,3,7,10,,,,
3539,2,1,3,,,,
11662,14,66,80,,,,
6458,6,66,72,,,,
8285,104,5,109,,,,
2529,12,11,23,,,,
13814,1,6,7,,,,
10322,4,8,12,,,,
4809,21,21,42,,,,
16278,3,4,7,,,,
4114,8,11,19,,,,
12904,8,0,8,,,,
3119,51,18,69,,,,
5378,151,54,205,,,,
9556,49,10,59,,,,
143,24,4,28,,,,
15827,7,8,15,,,,
15093,1,17,18,,,,
1542,16,9,25,,,,
972,6,21,27,,,,
5057,6,13,19,,,,
9721,22,7,29,,,,
1604,2,16,18,,,,
17252,3,9,12,,,,
15297,3,25,28,,,,
10861,1,11,12,,,,
761,26,14,40,,,,
13443,1,7,8,,,,
11707,28,40,68,,,,
10904,5,10,15,,,,
4215,9,6,15,,,,
12683,13,8,21,,,,
10061,34,0,34,,,,
6803,49,7,56,,,,
11788,4,3,7,,,,
1112,64,6,70,,,,
2054,7,1,8,,,,
13881,4,2,6,,,,
11183,18,1,19,,,,
12060,4,18,22,,,,
11530,1,1,2,,,,
16662,3,5,8,,,,
12720,12,5,17,,,,
10027,28,18,46,,,,
4594,7,0,7,,,,
160,434,59,493,,,,
10767,6,7,13,,,,
16129,6,3,9,,,,
1330,10,58,68,,,,
7139,9,10,19,,,,
2644,33,18,51,,,,
7134,6,12,18,,,,
6477,6,14,20,,,,
5750,13,7,20,,,,
3656,59,26,85,,,,
13486,2,7,9,,,,
16082,37,5,42,,,,
11982,17,2,19,,,,
10522,12,15,27,,,,
2951,27,7,34,,,,
14987,4,8,12,,,,
13909,6,0,6,,,,
17273,3,3,6,,,,
17302,1,4,5,,,,
3865,7,17,24,,,,
8113,9,0,9,,,,
16551,4,7,11,,,,
11206,2,2,4,,,,
5123,31,4,35,,,,
9384,1,14,15,,,,
13436,3,6,9,,,,
11700,24,19,43,,,,
9687,2,4,6,,,,
1640,327,18,345,,,,
9837,3,3,6,,,,
6207,9,17,26,,,,
12864,7,0,7,,,,
17048,14,3,17,,,,
9020,3,2,5,,,,
7011,3,1,4,,,,
3189,2,1,3,,,,
8577,4,5,9,,,,
956,4,2,6,,,,
12461,9,34,43,,,,
2079,1,14,15,,,,
11399,5,8,13,,,,
4549,6,19,25,,,,
12032,4,0,4,,,,
5482,166,44,210,,,,
4124,54,9,63,,,,
13707,9,0,9,,,,
12670,20,3,23,,,,
2615,67,10,77,,,,
15656,12,16,28,,,,
1726,29,65,94,,,,
10635,4,10,14,,,,
13754,9,9,18,,,,
11807,19,12,31,,,,
17436,4,3,7,,,,
8559,1,3,4,,,,
14020,4,3,7,,,,
14120,3,2,5,,,,
12983,2,1,3,,,,
10104,3,35,38,,,,
3326,1,1,2,,,,
17528,10,3,13,,,,
16879,4,11,15,,,,
6485,1,2,3,,,,
9989,5,8,13,,,,
13372,2,2,4,,,,
9055,37,7,44,,,,
2632,93,14,107,,,,
4660,3,80,83,,,,
2851,1,3,4,,,,
14350,6,31,37,,,,
16539,4,7,11,,,,
15002,15,2,17,,,,
13155,4,8,12,,,,
6413,11,3,14,,,,
2436,67,106,173,,,,
4937,11,7,18,,,,
5955,7,2,9,,,,
13418,2,0,2,,,,
7130,15,3,18,,,,
16179,3,5,8,,,,
2706,11,0,11,,,,
6765,7,7,14,,,,
1451,9,78,87,,,,
12667,7,4,11,,,,
16745,1,5,6,,,,
1251,19,21,40,,,,
10158,4,33,37,,,,
8719,1,1,2,,,,
15801,1,3,4,,,,
16638,11,11,22,,,,
2326,14,76,90,,,,
15878,6,3,9,,,,
3272,7,6,13,,,,
15310,4,11,15,,,,
16870,3,1,4,,,,
1485,66,1,67,,,,
76,4,61,65,,,,
5930,35,0,35,,,,
8702,2,5,7,,,,
11215,6,6,12,,,,
16407,13,1,14,,,,
3266,34,126,160,,,,
5962,5,18,23,,,,
2516,44,9,53,,,,
8680,20,0,20,,,,
10248,3,2,5,,,,
5286,48,24,72,,,,
12351,10,13,23,,,,
6873,53,11,64,,,,
15017,6,11,17,,,,
9256,14,1,15,,,,
5507,120,34,154,,,,
14145,7,18,25,,,,
12348,137,103,240,,,,
15347,1,8,9,,,,
1527,4,6,10,,,,
14651,8,7,15,,,,
5540,53,2,55,,,,
12074,5,50,55,,,,
5898,12,82,94,,,,
5862,1,3,4,,,,
15202,5,6,11,,,,
11697,73,3,76,,,,
16835,13,1,14,,,,
17079,7,2,9,,,,
14438,5,1,6,,,,
12052,9,0,9,,,,
6049,68,2,70,,,,
10965,4,0,4,,,,
6907,30,2,32,,,,
16128,1,3,4,,,,
7696,2,2,4,,,,
5612,22,32,54,,,,
14132,2,5,7,,,,
1310,33,7,40,,,,
16194,18,14,32,,,,
16141,1,9,10,,,,
16236,14,1,15,,,,
7224,4,1,5,,,,
7043,9,1,10,,,,
15960,4,0,4,,,,
5711,1,6,7,,,,
13467,2,10,12,,,,
521,3,8,11,,,,
8597,50,55,105,,,,
8349,1,1,2,,,,
11431,12,1,13,,,,
13235,67,9,76,,,,
16025,2,42,44,,,,
9433,4,17,21,,,,
2504,7,9,16,,,,
5883,6,0,6,,,,
9039,3,35,38,,,,
3505,6,3,9,,,,
7730,12,0,12,,,,
17003,5,4,9,,,,
4146,7,9,16,,,,
12672,14,2,16,,,,
35,7,13,20,,,,
4599,46,19,65,,,,
15830,3,4,7,,,,
4957,12,0,12,,,,
15703,3,4,7,,,,
6073,42,5,47,,,,
6363,1,1,2,,,,
5301,31,1,32,,,,
17693,3,1,4,,,,
9763,3,4,7,,,,
15928,2,3,5,,,,
5895,16,16,32,,,,
870,92,14,106,,,,
14851,10,5,15,,,,
4387,9,65,74,,,,
11729,18,53,71,,,,
12938,6,11,17,,,,
5553,6,7,13,,,,
8969,14,1,15,,,,
1518,7,15,22,,,,
13585,9,23,32,,,,
3772,2,0,2,,,,
1901,15,9,24,,,,
3548,4,13,17,,,,
17012,1,6,7,,,,
12766,2,2,4,,,,
5003,1,2,3,,,,
10939,5,0,5,,,,
17060,9,5,14,,,,
17166,3,13,16,,,,
607,6,12,18,,,,
12731,3,0,3,,,,
5921,52,8,60,,,,
6017,4,3,7,,,,
13991,2,5,7,,,,
10714,15,4,19,,,,
11347,1,1,2,,,,
11411,1,2,3,,,,
9193,7,3,10,,,,
12063,6,18,24,,,,
9057,14,33,47,,,,
14133,5,27,32,,,,
2419,5,37,42,,,,
1590,221,7,228,,,,
12706,2,8,10,,,,
5810,2,9,11,,,,
8828,4,3,7,,,,
13111,3,12,15,,,,
11450,2,42,44,,,,
8548,26,38,64,,,,
7802,19,8,27,,,,
348,1,43,44,,,,
16401,2,7,9,,,,
16881,2,2,4,,,,
918,1,8,9,,,,
11189,7,40,47,,,,
8525,25,67,92,,,,
223,54,4,58,,,,
4974,1,0,1,,,,
365,1,49,50,,,,
16255,8,3,11,,,,
15793,13,4,17,,,,
4167,20,11,31,,,,
9948,14,72,86,,,,
4227,55,41,96,,,,
13791,4,4,8,,,,
5073,14,4,18,,,,
6593,29,17,46,,,,
15029,9,11,20,,,,
4996,13,2,15,,,,
7301,19,7,26,,,,
2601,121,24,145,,,,
3662,5,16,21,,,,
3100,20,15,35,,,,
5287,31,4,35,,,,
5024,4,47,51,,,,
3945,47,6,53,,,,
4569,20,1,21,,,,
1343,50,65,115,,,,
4107,16,20,36,,,,
10484,54,6,60,,,,
16258,5,2,7,,,,
9152,7,1,8,,,,
7080,1,6,7,,,,
11927,1,2,3,,,,
16554,5,0,5,,,,
1509,16,45,61,,,,
16418,38,3,41,,,,
1731,14,33,47,,,,
14398,15,7,22,,,,
16645,9,5,14,,,,
16783,10,3,13,,,,
11826,1,14,15,,,,
2317,63,23,86,,,,
1695,15,16,31,,,,
7781,9,9,18,,,,
10290,7,22,29,,,,
7755,6,0,6,,,,
15530,20,20,40,,,,
1258,3,0,3,,,,
595,1,38,39,,,,
491,14,32,46,,,,
1570,25,102,127,,,,
17131,3,22,25,,,,
14186,64,7,71,,,,
903,20,42,62,,,,
16042,8,2,10,,,,
12814,2,3,5,,,,
14024,5,6,11,,,,
2866,6,21,27,,,,
8267,21,34,55,,,,
8318,32,17,49,,,,
10433,21,1,22,,,,
7365,1,13,14,,,,
13487,6,0,6,,,,
12077,8,8,16,,,,
7585,1,4,5,,,,
9114,9,2,11,,,,
17084,4,3,7,,,,
4093,54,5,59,,,,
14896,21,1,22,,,,
645,36,7,43,,,,
16675,1,8,9,,,,
5597,22,17,39,,,,
12220,17,0,17,,,,
4196,46,103,149,,,,
444,2,4,6,,,,
16660,11,3,14,,,,
12698,2,7,9,,,,
16022,29,37,66,,,,
6414,11,8,19,,,,
8176,16,10,26,,,,
16591,2,5,7,,,,
2887,56,13,69,,,,
14914,3,2,5,,,,
366,3,10,13,,,,
17500,5,1,6,,,,
17573,2,4,6,,,,
3825,7,4,11,,,,
10778,3,0,3,,,,
17041,3,8,11,,,,
14058,3,7,10,,,,
1986,23,49,72,,,,
824,22,18,40,,,,
5367,98,96,194,,,,
14843,5,9,14,,,,
3567,1,0,1,,,,
11470,4,0,4,,,,
5816,13,18,31,,,,
16197,13,18,31,,,,
3544,3,20,23,,,,
10985,4,5,9,,,,
4213,8,39,47,,,,
14621,1,3,4,,,,
14407,1,5,6,,,,
7260,18,0,18,,,,
15858,6,1,7,,,,
13009,2,6,8,,,,
10063,10,1,11,,,,
17346,16,0,16,,,,
7399,14,1,15,,,,
8962,41,17,58,,,,
6614,17,28,45,,,,
2630,37,88,125,,,,
16176,10,15,25,,,,
2276,131,18,149,,,,
5828,4,76,80,,,,
14696,12,39,51,,,,
4398,7,1,8,,,,
3599,29,14,43,,,,
16787,3,4,7,,,,
10520,15,10,25,,,,
6305,16,17,33,,,,
11672,13,51,64,,,,
7858,10,8,18,,,,
1950,4,372,376,,,,
2981,25,21,46,,,,
4161,56,1,57,,,,
3646,2,5,7,,,,
3177,57,15,72,,,,
12029,8,8,16,,,,
17030,9,5,14,,,,
16066,9,0,9,,,,
14215,24,13,37,,,,
2838,2,71,73,,,,
2164,8,2,10,,,,
16216,5,9,14,,,,
5031,15,1,16,,,,
12897,28,16,44,,,,
9056,34,18,52,,,,
5667,28,10,38,,,,
11074,9,33,42,,,,
13478,6,2,8,,,,
4372,44,5,49,,,,
535,2,2,4,,,,
13021,37,45,82,,,,
7368,5,5,10,,,,
8967,47,20,67,,,,
10388,3,7,10,,,,
10151,1,3,4,,,,
16438,5,3,8,,,,
12948,5,4,9,,,,
3973,31,14,45,,,,
6411,1,4,5,,,,
5855,3,17,20,,,,
8909,2,3,5,,,,
9897,29,3,32,,,,
14789,1,7,8,,,,
2510,3,15,18,,,,
13077,2,6,8,,,,
5014,10,76,86,,,,
15280,4,0,4,,,,
10279,4,4,8,,,,
12279,6,2,8,,,,
6588,5,4,9,,,,
1083,4,3,7,,,,
5925,6,2,8,,,,
2040,4,9,13,,,,
6351,4,1,5,,,,
11986,1,10,11,,,,
2966,22,44,66,,,,
12455,14,50,64,,,,
7037,4,6,10,,,,
1594,28,17,45,,,,
7545,16,17,33,,,,
11487,15,11,26,,,,
2284,3,7,10,,,,
6844,15,24,39,,,,
13079,3,4,7,,,,
5769,29,0,29,,,,
13355,1,3,4,,,,
13803,2,2,4,,,,
11616,1,0,1,,,,
15717,3,2,5,,,,
14918,3,4,7,,,,
10667,7,2,9,,,,
14507,16,5,21,,,,
6250,4,5,9,,,,
15923,3,3,6,,,,
11799,1,11,12,,,,
9801,1,6,7,,,,
12207,2,0,2,,,,
3277,24,52,76,,,,
10478,28,12,40,,,,
6283,24,15,39,,,,
13780,2,3,5,,,,
9415,7,12,19,,,,
17589,4,13,17,,,,
13621,4,4,8,,,,
6582,12,16,28,,,,
4122,2,19,21,,,,
6301,122,53,175,,,,
10056,41,16,57,,,,
11545,1,2,3,,,,
9261,1,5,6,,,,
17831,7,5,12,,,,
17167,10,4,14,,,,
13176,4,15,19,,,,
11860,5,9,14,,,,
2959,4,1,5,,,,
12324,4,4,8,,,,
10792,2,9,11,,,,
2225,8,22,30,,,,
1751,33,6,39,,,,
15765,5,4,9,,,,
13645,28,12,40,,,,
1964,21,42,63,,,,
1601,20,12,32,,,,
5341,25,18,43,,,,
14292,5,16,21,,,,
15562,3,2,5,,,,
6589,10,69,79,,,,
10384,6,3,9,,,,
3472,34,3,37,,,,
1722,128,76,204,,,,
6669,29,9,38,,,,
10740,7,4,11,,,,
12263,15,17,32,,,,
12245,3,0,3,,,,
1445,4,1,5,,,,
16088,39,2,41,,,,
9366,1,13,14,,,,
3379,18,7,25,,,,
6325,4,8,12,,,,
15033,3,1,4,,,,
5214,20,6,26,,,,
1745,4,13,17,,,,
12475,26,25,51,,,,
13715,6,15,21,,,,
14490,4,8,12,,,,
16570,3,1,4,,,,
5983,21,1,22,,,,
2624,61,57,118,,,,
4311,61,59,120,,,,
3250,5,7,12,,,,
6239,12,55,67,,,,
1260,23,39,62,,,,
2505,4,11,15,,,,
16317,5,0,5,,,,
17751,3,0,3,,,,
14561,15,35,50,,,,
2386,9,98,107,,,,
2183,57,11,68,,,,
4503,25,5,30,,,,
7547,1,35,36,,,,
3573,6,1,7,,,,
13882,8,23,31,,,,
4753,12,18,30,,,,
5558,9,37,46,,,,
3320,3,51,54,,,,
540,10,113,123,,,,
9889,13,15,28,,,,
16311,11,5,16,,,,
12255,18,20,38,,,,
3160,23,16,39,,,,
7005,31,16,47,,,,
587,27,5,32,,,,
2254,22,37,59,,,,
5939,4,3,7,,,,
6206,2,8,10,,,,
9894,10,11,21,,,,
6851,48,16,64,,,,
6236,21,6,27,,,,
17393,2,8,10,,,,
13075,6,13,19,,,,
10260,14,10,24,,,,
3676,21,6,27,,,,
3261,12,10,22,,,,
11052,1,5,6,,,,
17300,1,6,7,,,,
7553,11,16,27,,,,
1938,26,27,53,,,,
4550,24,38,62,,,,
10047,17,12,29,,,,
17269,5,14,19,,,,
7955,15,31,46,,,,
1345,29,15,44,,,,
7864,2,2,4,,,,
15527,2,7,9,,,,
16046,10,20,30,,,,
1023,7,36,43,,,,
7283,2,13,15,,,,
2086,5,3,8,,,,
11979,2,5,7,,,,
13338,17,60,77,,,,
9494,6,7,13,,,,
1452,6,4,10,,,,
2345,5,9,14,,,,
2343,51,26,77,,,,
17259,1,36,37,,,,
10267,9,1,10,,,,
3712,25,1,26,,,,
3720,55,43,98,,,,
17679,14,1,15,,,,
2000,26,1,27,,,,
16440,6,6,12,,,,
9528,1,6,7,,,,
12122,3,2,5,,,,
8421,1,0,1,,,,
10062,1,30,31,,,,
13416,3,2,5,,,,
7506,56,48,104,,,,
10054,21,81,102,,,,
17496,3,2,5,,,,
4862,33,0,33,,,,
652,42,12,54,,,,
2589,6,11,17,,,,
17399,2,2,4,,,,
16617,11,11,22,,,,
13341,3,0,3,,,,
10136,2,2,4,,,,
16689,19,15,34,,,,
14001,1,6,7,,,,
6504,11,28,39,,,,
17152,8,0,8,,,,
13705,2,3,5,,,,
8331,15,26,41,,,,
3570,44,6,50,,,,
7243,3,2,5,,,,
6439,3,16,19,,,,
12480,10,5,15,,,,
16731,4,0,4,,,,
11328,148,36,184,,,,
12446,126,51,177,,,,
9843,61,114,175,,,,
11926,2,7,9,,,,
3823,4,0,4,,,,
59,118,16,134,,,,
16105,10,0,10,,,,
15073,5,4,9,,,,
4115,45,17,62,,,,
699,70,0,70,,,,
2558,19,8,27,,,,
3206,16,15,31,,,,
16157,5,24,29,,,,
4056,11,14,25,,,,
602,41,65,106,,,,
4248,13,6,19,,,,
11834,6,1,7,,,,
17081,5,0,5,,,,
10553,12,33,45,,,,
17373,4,1,5,,,,
3885,52,5,57,,,,
17574,3,3,6,,,,
13499,4,12,16,,,,
13740,10,2,12,,,,
13339,6,30,36,,,,
16338,6,5,11,,,,
15488,3,12,15,,,,
12651,8,0,8,,,,
13124,5,2,7,,,,
8125,2,11,13,,,,
15974,15,20,35,,,,
10570,2,8,10,,,,
3719,6,12,18,,,,
8585,36,41,77,,,,
13213,14,4,18,,,,
12310,16,16,32,,,,
8668,7,10,17,,,,
7450,3,5,8,,,,
16759,4,2,6,,,,
10950,1,5,6,,,,
14630,1,13,14,,,,
12054,2,21,23,,,,
5010,38,6,44,,,,
11976,18,2,20,,,,
5398,24,11,35,,,,
8195,38,2,40,,,,
7298,41,6,47,,,,
12022,6,8,14,,,,
13239,28,8,36,,,,
11876,4,9,13,,,,
12331,2,28,30,,,,
14458,6,2,8,,,,
4711,41,7,48,,,,
13375,2,1,3,,,,
17594,6,1,7,,,,
739,72,3,75,,,,
15022,6,22,28,,,,
14528,21,3,24,,,,
16942,5,0,5,,,,
6698,3,29,32,,,,
17403,11,1,12,,,,
14435,3,4,7,,,,
10774,3,16,19,,,,
5382,45,135,180,,,,
10123,6,8,14,,,,
10544,11,20,31,,,,
15684,9,1,10,,,,
370,11,18,29,,,,
13039,8,35,43,,,,
13322,11,4,15,,,,
3328,10,17,27,,,,
87,24,28,52,,,,
3673,2,6,8,,,,
10961,3,0,3,,,,
5288,27,9,36,,,,
4494,7,18,25,,,,
2927,1,5,6,,,,
501,22,5,27,,,,
2201,59,135,194,,,,
15065,1,1,2,,,,
14596,2,2,4,,,,
9195,20,1,21,,,,
9061,3,12,15,,,,
5155,6,10,16,,,,
4763,44,11,55,,,,
1635,159,1,160,,,,
8111,6,5,11,,,,
8708,21,2,23,,,,
4824,1,25,26,,,,
7401,17,0,17,,,,
987,63,11,74,,,,
15292,1,4,5,,,,
10805,3,2,5,,,,
9426,4,13,17,,,,
16746,4,1,5,,,,
251,3,3,6,,,,
12975,25,38,63,,,,
4598,12,4,16,,,,
15975,53,3,56,,,,
10776,10,1,11,,,,
4267,126,5,131,,,,
9398,5,11,16,,,,
17408,1,1,2,,,,
6401,8,23,31,,,,
1569,174,35,209,,,,
11109,2,1,3,,,,
17177,4,2,6,,,,
16091,17,3,20,,,,
3558,170,47,217,,,,
2646,71,3,74,,,,
17766,3,1,4,,,,
5456,23,49,72,,,,
9343,13,1,14,,,,
5783,3,1,4,,,,
12861,1,1,2,,,,
6257,49,19,68,,,,
3610,3,10,13,,,,
17031,33,0,33,,,,
14067,1,18,19,,,,
9295,10,1,11,,,,
9900,22,2,24,,,,
13732,17,4,21,,,,
11537,14,6,20,,,,
9182,1,0,1,,,,
8355,2,3,5,,,,
16596,12,5,17,,,,
14162,7,12,19,,,,
14603,17,7,24,,,,
14629,11,2,13,,,,
11318,10,13,23,,,,
2899,33,2,35,,,,
4040,1,21,22,,,,
13291,1,1,2,,,,
5359,99,82,181,,,,
11865,3,4,7,,,,
12932,12,6,18,,,,
8060,3,7,10,,,,
8871,22,26,48,,,,
3969,1,7,8,,,,
14723,7,4,11,,,,
6514,10,3,13,,,,
8185,196,61,257,,,,
6433,26,73,99,,,,
5985,10,13,23,,,,
12317,7,61,68,,,,
4461,5,6,11,,,,
9346,3,28,31,,,,
16110,1,17,18,,,,
2656,6,12,18,,,,
17748,11,12,23,,,,
11839,1,7,8,,,,
10595,5,1,6,,,,
12537,17,10,27,,,,
5573,10,22,32,,,,
4030,129,64,193,,,,
2438,9,42,51,,,,
12989,2,5,7,,,,
3026,13,13,26,,,,
858,9,9,18,,,,
10261,8,10,18,,,,
15468,2,1,3,,,,
13325,1,1,2,,,,
10483,37,11,48,,,,
12365,12,2,14,,,,
283,12,0,12,,,,
15812,1,0,1,,,,
6751,2,38,40,,,,
10236,2,26,28,,,,
12723,1,6,7,,,,
15909,1,1,2,,,,
17050,6,7,13,,,,
3882,41,51,92,,,,
2205,4,13,17,,,,
732,95,29,124,,,,
17298,1,0,1,,,,
730,42,33,75,,,,
10347,2,4,6,,,,
15817,19,9,28,,,,
8956,2,0,2,,,,
7817,7,1,8,,,,
7190,10,1,11,,,,
10671,26,5,31,,,,
9746,2,2,4,,,,
1614,76,170,246,,,,
7100,33,6,39,,,,
8713,14,5,19,,,,
12175,5,4,9,,,,
13160,51,4,55,,,,
913,6,14,20,,,,
17,18,12,30,,,,
13725,28,14,42,,,,
8954,10,22,32,,,,
9954,12,0,12,,,,
13979,9,7,16,,,,
1348,28,9,37,,,,
8520,6,1,7,,,,
3860,7,19,26,,,,
736,26,67,93,,,,
45,6,7,13,,,,
15440,4,2,6,,,,
14901,4,4,8,,,,
14307,4,5,9,,,,
10083,4,1,5,,,,
4313,5,7,12,,,,
13440,5,2,7,,,,
5954,16,7,23,,,,
3557,45,30,75,,,,
5481,89,39,128,,,,
16170,14,2,16,,,,
1469,4,11,15,,,,
1247,11,1,12,,,,
2222,17,12,29,,,,
15794,7,5,12,,,,
480,6,15,21,,,,
4781,19,16,35,,,,
10311,6,1,7,,,,
11909,2,2,4,,,,
17531,2,6,8,,,,
17499,4,4,8,,,,
11236,8,16,24,,,,
15469,1,2,3,,,,
10527,12,48,60,,,,
7983,5,16,21,,,,
11059,61,31,92,,,,
16,13,2,15,,,,
6273,20,87,107,,,,
16327,7,6,13,,,,
17274,2,6,8,,,,
1924,33,48,81,,,,
12338,101,6,107,,,,
4002,250,3,253,,,,
16102,5,4,9,,,,
9750,13,4,17,,,,
6109,60,0,60,,,,
14147,1,4,5,,,,
6754,20,5,25,,,,
16868,1,2,3,,,,
8146,8,12,20,,,,
7314,15,0,15,,,,
11837,5,28,33,,,,
13108,5,0,5,,,,
1517,10,28,38,,,,
3162,1,5,6,,,,
6627,26,12,38,,,,
6195,21,32,53,,,,
15416,21,4,25,,,,
15307,3,6,9,,,,
12321,10,8,18,,,,
9263,5,12,17,,,,
10321,2,0,2,,,,
2606,31,90,121,,,,
8980,20,45,65,,,,
3575,6,39,45,,,,
586,8,0,8,,,,
1449,48,13,61,,,,
10933,2,4,6,,,,
10025,28,85,113,,,,
7344,38,25,63,,,,
14111,1,0,1,,,,
4855,39,14,53,,,,
4512,2,14,16,,,,
14673,9,8,17,,,,
8812,4,1,5,,,,
14759,5,0,5,,,,
1704,15,25,40,,,,
15592,5,6,11,,,,
10676,1,12,13,,,,
5170,2,1,3,,,,
8399,21,5,26,,,,
4041,1,0,1,,,,
13890,4,11,15,,,,
13190,5,13,18,,,,
7088,10,42,52,,,,
4801,25,20,45,,,,
11506,11,5,16,,,,
7436,13,0,13,,,,
12070,6,7,13,,,,
4388,6,6,12,,,,
6114,9,3,12,,,,
11015,7,0,7,,,,
9105,3,61,64,,,,
1978,3,8,11,,,,
9710,2,2,4,,,,
9265,5,11,16,,,,
7646,3,21,24,,,,
6208,4,11,15,,,,
17226,12,10,22,,,,
5424,83,135,218,,,,
7295,2,1,3,,,,
5959,15,5,20,,,,
15321,7,14,21,,,,
196,11,7,18,,,,
14127,11,0,11,,,,
2394,70,31,101,,,,
15101,4,11,15,,,,
303,125,7,132,,,,
1739,294,20,314,,,,
4366,67,2,69,,,,
410,21,1,22,,,,
16127,3,4,7,,,,
9981,2,135,137,,,,
10295,2,8,10,,,,
10523,25,16,41,,,,
5173,13,10,23,,,,
4091,12,48,60,,,,
796,130,0,130,,,,
13492,1,9,10,,,,
7167,2,72,74,,,,
2469,63,20,83,,,,
6456,13,8,21,,,,
5447,105,4,109,,,,
428,1,2,3,,,,
7321,8,6,14,,,,
2756,1,57,58,,,,
17199,3,0,3,,,,
17561,2,4,6,,,,
11497,19,24,43,,,,
13000,2,2,4,,,,
17355,7,5,12,,,,
14781,18,2,20,,,,
17479,1,0,1,,,,
11949,34,49,83,,,,
8456,2,7,9,,,,
14763,4,6,10,,,,
6447,9,16,25,,,,
146,5,23,28,,,,
4238,6,0,6,,,,
8618,3,5,8,,,,
10771,16,1,17,,,,
13263,7,3,10,,,,
7823,33,16,49,,,,
9451,34,23,57,,,,
9776,1,19,20,,,,
7782,14,12,26,,,,
13756,4,4,8,,,,
9210,6,8,14,,,,
4941,10,11,21,,,,
10664,1,7,8,,,,
4987,2,7,9,,,,
15170,6,9,15,,,,
1958,24,22,46,,,,
17396,1,5,6,,,,
17655,4,1,5,,,,
15075,2,5,7,,,,
10496,3,22,25,,,,
10091,2,49,51,,,,
320,30,3,33,,,,
9695,7,1,8,,,,
3876,15,19,34,,,,
8145,21,5,26,,,,
11056,8,1,9,,,,
12598,5,6,11,,,,
13992,9,4,13,,,,
638,39,36,75,,,,
8167,68,26,94,,,,
17891,16,3,19,,,,
14096,6,0,6,,,,
9722,58,4,62,,,,
810,19,14,33,,,,
11524,10,5,15,,,,
12028,8,0,8,,,,
2334,32,12,44,,,,
10508,11,46,57,,,,
5271,5,3,8,,,,
5211,15,27,42,,,,
17437,2,4,6,,,,
16350,21,17,38,,,,
11362,2,1,3,,,,
10475,21,45,66,,,,
13187,10,27,37,,,,
360,3,21,24,,,,
6701,78,6,84,,,,
13030,4,4,8,,,,
8662,22,10,32,,,,
16788,4,2,6,,,,
16568,4,1,5,,,,
7539,56,78,134,,,,
9633,13,17,30,,,,
5663,31,3,34,,,,
17342,1,6,7,,,,
7332,3,3,6,,,,
13529,2,7,9,,,,
397,5,2,7,,,,
8998,7,62,69,,,,
15970,3,5,8,,,,
16395,20,1,21,,,,
1477,11,23,34,,,,
16397,9,9,18,,,,
13119,56,0,56,,,,
14910,5,5,10,,,,
14374,5,0,5,,,,
6459,1,2,3,,,,
7550,29,23,52,,,,
790,99,111,210,,,,
15678,9,2,11,,,,
2534,15,7,22,,,,
2405,9,126,135,,,,
14112,5,18,23,,,,
8092,1,0,1,,,,
4496,12,15,27,,,,
3046,12,57,69,,,,
1166,1,15,16,,,,
2134,27,0,27,,,,
5199,25,6,31,,,,
7582,3,5,8,,,,
1021,18,5,23,,,,
530,4,7,11,,,,
15826,5,2,7,,,,
11137,8,1,9,,,,
6389,24,4,28,,,,
13846,3,0,3,,,,
11125,6,2,8,,,,
17716,2,7,9,,,,
12863,1,11,12,,,,
15158,2,4,6,,,,
17123,20,4,24,,,,
3997,7,22,29,,,,
16027,6,35,41,,,,
1637,18,254,272,,,,
100,92,137,229,,,,
97,37,73,110,,,,
10239,6,5,11,,,,
12823,9,0,9,,,,
7821,3,18,21,,,,
13301,2,1,3,,,,
3242,28,35,63,,,,
7842,1,15,16,,,,
3243,7,21,28,,,,
12732,7,21,28,,,,
14515,9,3,12,,,,
12442,23,25,48,,,,
3781,9,8,17,,,,
10127,10,1,11,,,,
1566,56,35,91,,,,
17147,2,5,7,,,,
7743,12,12,24,,,,
4097,53,13,66,,,,
14286,7,0,7,,,,
12412,5,13,18,,,,
4132,12,10,22,,,,
5329,11,7,18,,,,
5291,12,9,21,,,,
17363,1,1,2,,,,
11614,10,12,22,,,,
2727,1,3,4,,,,
2314,76,40,116,,,,
13922,9,0,9,,,,
10429,3,1,4,,,,
9499,13,8,21,,,,
3133,56,33,89,,,,
9359,9,5,14,,,,
13064,4,2,6,,,,
11195,15,0,15,,,,
7276,12,4,16,,,,
3153,3,9,12,,,,
4589,49,4,53,,,,
8817,2,2,4,,,,
3262,2,21,23,,,,
5736,29,75,104,,,,
10513,4,10,14,,,,
17419,3,2,5,,,,
2700,12,4,16,,,,
17156,1,1,2,,,,
330,8,2,10,,,,
9759,2,61,63,,,,
6329,29,105,134,,,,
4875,4,4,8,,,,
6051,9,0,9,,,,
10014,6,1,7,,,,
6067,35,22,57,,,,
17148,5,3,8,,,,
2830,13,34,47,,,,
6652,10,1,11,,,,
7674,7,2,9,,,,
1244,5,3,8,,,,
9812,4,1,5,,,,
3040,6,4,10,,,,
10593,39,3,42,,,,
4088,5,6,11,,,,
12912,5,5,10,,,,
8448,1,3,4,,,,
17707,2,4,6,,,,
1055,4,13,17,,,,
12417,3,3,6,,,,
16598,2,4,6,,,,
3815,8,5,13,,,,
10454,3,1,4,,,,
17475,2,6,8,,,,
16976,3,8,11,,,,
8486,2,0,2,,,,
8654,8,8,16,,,,
15056,5,12,17,,,,
10839,1,8,9,,,,
5325,11,19,30,,,,
6251,15,13,28,,,,
12959,2,1,3,,,,
15924,1,0,1,,,,
1144,11,10,21,,,,
10339,28,5,33,,,,
14704,6,22,28,,,,
9509,5,6,11,,,,
17380,4,0,4,,,,
3038,21,6,27,,,,
13948,9,7,16,,,,
8771,14,31,45,,,,
16475,9,6,15,,,,
2332,50,21,71,,,,
6693,13,12,25,,,,
8526,4,54,58,,,,
10500,15,15,30,,,,
5524,56,38,94,,,,
2904,13,8,21,,,,
14976,11,18,29,,,,
7979,12,11,23,,,,
7671,4,1,5,,,,
8094,9,3,12,,,,
4390,2,2,4,,,,
13837,3,0,3,,,,
2567,5,20,25,,,,
7258,7,11,18,,,,
15412,30,6,36,,,,
13931,6,2,8,,,,
10103,9,3,12,,,,
13154,6,1,7,,,,
10497,20,18,38,,,,
8512,1,0,1,,,,
7876,36,68,104,,,,
12235,10,7,17,,,,
5882,12,1,13,,,,
15267,3,0,3,,,,
12044,1,3,4,,,,
2369,23,19,42,,,,
16500,2,7,9,,,,
8915,4,12,16,,,,
16188,19,6,25,,,,
6062,14,2,16,,,,
12765,5,2,7,,,,
5971,8,2,10,,,,
5754,3,108,111,,,,
13037,1,5,6,,,,
11647,31,7,38,,,,
13344,12,2,14,,,,
2616,82,2,84,,,,
15232,10,3,13,,,,
8179,6,24,30,,,,
9051,4,0,4,,,,
15613,4,7,11,,,,
14221,1,11,12,,,,
3387,4,0,4,,,,
9529,2,11,13,,,,
9736,21,31,52,,,,
17705,1,2,3,,,,
17603,2,1,3,,,,
17674,3,2,5,,,,
9681,20,7,27,,,,
3651,24,25,49,,,,
14287,6,0,6,,,,
976,11,11,22,,,,
13708,30,23,53,,,,
1783,1,36,37,,,,
8863,3,4,7,,,,
985,3,13,16,,,,
309,14,16,30,,,,
15876,2,2,4,,,,
9604,3,10,13,,,,
3384,8,9,17,,,,
15344,1,2,3,,,,
15520,1,3,4,,,,
10677,1,0,1,,,,
9901,8,4,12,,,,
5579,2,3,5,,,,
13204,33,4,37,,,,
9671,5,23,28,,,,
13923,4,8,12,,,,
2001,48,18,66,,,,
6260,3,1,4,,,,
1628,50,215,265,,,,
267,1,5,6,,,,
2215,6,0,6,,,,
14233,1,4,5,,,,
14536,28,5,33,,,,
17723,1,0,1,,,,
17132,19,7,26,,,,
15490,1,2,3,,,,
11128,12,4,16,,,,
10940,3,0,3,,,,
88,94,56,150,,,,
9855,37,80,117,,,,
6945,1,7,8,,,,
2875,4,27,31,,,,
3082,9,10,19,,,,
6827,11,19,30,,,,
11407,1,2,3,,,,
16446,12,13,25,,,,
5357,38,172,210,,,,
1859,17,40,57,,,,
4314,60,5,65,,,,
7658,29,9,38,,,,
1256,11,21,32,,,,
11678,112,1,113,,,,
2071,9,23,32,,,,
6306,9,4,13,,,,
14653,6,4,10,,,,
4532,47,41,88,,,,
10935,3,8,11,,,,
16326,5,1,6,,,,
14122,6,4,10,,,,
11574,6,4,10,,,,
4288,46,12,58,,,,
13105,2,5,7,,,,
1818,103,26,129,,,,
3892,12,41,53,,,,
12429,14,5,19,,,,
6465,29,16,45,,,,
7429,3,3,6,,,,
4341,13,12,25,,,,
6817,21,8,29,,,,
3109,1,7,8,,,,
4513,54,24,78,,,,
3582,23,17,40,,,,
1550,1,3,4,,,,
8944,4,31,35,,,,
10199,12,15,27,,,,
5021,37,2,39,,,,
4207,3,37,40,,,,
3993,1,13,14,,,,
8797,17,18,35,,,,
10448,9,1,10,,,,
817,24,6,30,,,,
15737,12,0,12,,,,
2422,21,49,70,,,,
7558,16,45,61,,,,
13669,3,42,45,,,,
17763,6,3,9,,,,
15447,4,7,11,,,,
10914,2,35,37,,,,
13161,27,2,29,,,,
5380,14,202,216,,,,
7666,36,4,40,,,,
6424,13,50,63,,,,
8227,22,29,51,,,,
12966,6,9,15,,,,
12668,13,9,22,,,,
6959,28,80,108,,,,
9832,12,0,12,,,,
12067,18,5,23,,,,
15833,6,0,6,,,,
4086,2,16,18,,,,
9117,3,18,21,,,,
917,33,17,50,,,,
9205,6,11,17,,,,
17087,2,4,6,,,,
12130,10,2,12,,,,
14891,11,15,26,,,,
2341,147,105,252,,,,
3925,50,4,54,,,,
10085,28,7,35,,,,
15245,8,5,13,,,,
17271,22,6,28,,,,
15495,1,0,1,,,,
11478,13,4,17,,,,
10587,9,15,24,,,,
17790,2,9,11,,,,
967,57,17,74,,,,
13947,3,9,12,,,,
4851,16,15,31,,,,
10801,25,0,25,,,,
2339,14,36,50,,,,
12289,9,10,19,,,,
11818,23,5,28,,,,
7237,8,17,25,,,,
2665,121,7,128,,,,
14560,24,73,97,,,,
10502,19,12,31,,,,
1941,49,73,122,,,,
7684,9,6,15,,,,
2335,74,4,78,,,,
14305,2,2,4,,,,
620,45,32,77,,,,
14119,1,5,6,,,,
16861,1,1,2,,,,
15738,4,15,19,,,,
9838,3,0,3,,,,
14737,6,22,28,,,,
16948,3,0,3,,,,
14717,1,5,6,,,,
2180,1,25,26,,,,
2862,70,10,80,,,,
16458,6,1,7,,,,
7627,10,11,21,,,,
3653,50,61,111,,,,
12092,10,4,14,,,,
9200,7,8,15,,,,
17293,5,7,12,,,,
14973,12,8,20,,,,
2152,4,24,28,,,,
1068,4,6,10,,,,
9583,36,4,40,,,,
9225,4,0,4,,,,
15887,3,2,5,,,,
8697,6,16,22,,,,
3524,1,8,9,,,,
4936,63,6,69,,,,
14090,9,6,15,,,,
15389,27,40,67,,,,
14442,1,9,10,,,,
3319,16,18,34,,,,
15780,3,0,3,,,,
17609,2,7,9,,,,
16926,2,13,15,,,,
16193,6,11,17,,,,
6748,3,0,3,,,,
5602,4,3,7,,,,
9545,44,7,51,,,,
15268,48,6,54,,,,
9362,3,4,7,,,,
11993,12,13,25,,,,
8925,19,1,20,,,,
10342,4,1,5,,,,
1602,4,57,61,,,,
8189,8,18,26,,,,
11329,61,120,181,,,,
14853,6,18,24,,,,
2352,10,14,24,,,,
6622,15,14,29,,,,
383,19,2,21,,,,
5445,107,40,147,,,,
12956,3,1,4,,,,
7822,1,15,16,,,,
10230,18,0,18,,,,
17876,2,1,3,,,,
17113,9,1,10,,,,
1139,35,9,44,,,,
5230,14,4,18,,,,
11995,2,13,15,,,,
538,17,128,145,,,,
4379,26,5,31,,,,
6466,2,7,9,,,,
10376,7,15,22,,,,
16167,21,9,30,,,,
11544,3,9,12,,,,
7934,6,0,6,,,,
4208,9,35,44,,,,
16100,22,3,25,,,,
3283,48,18,66,,,,
12471,9,25,34,,,,
16355,6,9,15,,,,
16818,6,9,15,,,,
8466,1,0,1,,,,
14413,8,5,13,,,,
942,41,1,42,,,,
7063,1,0,1,,,,
17712,2,2,4,,,,
10417,3,7,10,,,,
8514,28,1,29,,,,
13071,5,1,6,,,,
11846,6,5,11,,,,
16414,5,2,7,,,,
616,2,14,16,,,,
11495,64,51,115,,,,
6159,6,6,12,,,,
272,1,11,12,,,,
12681,1,7,8,,,,
8553,2,7,9,,,,
16779,2,1,3,,,,
6965,12,14,26,,,,
16008,12,29,41,,,,
1307,25,77,102,,,,
10375,2,29,31,,,,
12109,29,10,39,,,,
13409,51,9,60,,,,
5639,4,4,8,,,,
11901,2,17,19,,,,
12456,15,12,27,,,,
7561,35,0,35,,,,
14289,6,4,10,,,,
5617,12,5,17,,,,
8500,3,1,4,,,,
12694,26,0,26,,,,
1064,93,128,221,,,,
16585,5,7,12,,,,
10851,4,1,5,,,,
945,15,37,52,,,,
1545,4,15,19,,,,
12618,8,5,13,,,,
11453,5,0,5,,,,
7128,14,4,18,,,,
7579,4,10,14,,,,
7942,23,14,37,,,,
170,329,29,358,,,,
5131,6,4,10,,,,
3722,97,58,155,,,,
16546,9,1,10,,,,
9525,4,0,4,,,,
7086,3,4,7,,,,
2378,169,20,189,,,,
3896,7,11,18,,,,
12840,13,8,21,,,,
9670,6,13,19,,,,
1472,11,4,15,,,,
1210,41,2,43,,,,
12555,3,23,26,,,,
798,59,21,80,,,,
3707,22,38,60,,,,
10896,2,8,10,,,,
16160,8,1,9,,,,
6615,9,4,13,,,,
2846,163,7,170,,,,
15771,10,10,20,,,,
11386,2,2,4,,,,
12936,5,6,11,,,,
8030,9,57,66,,,,
15024,3,9,12,,,,
3690,9,16,25,,,,
500,15,1,16,,,,
1713,52,9,61,,,,
4907,10,5,15,,,,
8806,2,2,4,,,,
7157,7,3,10,,,,
7336,3,1,4,,,,
393,1,0,1,,,,
2544,4,1,5,,,,
7732,18,1,19,,,,
4202,16,39,55,,,,
4973,2,0,2,,,,
6254,13,52,65,,,,
5948,15,0,15,,,,
4343,60,7,67,,,,
2085,57,11,68,,,,
9338,7,13,20,,,,
6138,3,2,5,,,,
14212,20,21,41,,,,
6337,10,11,21,,,,
4043,1,53,54,,,,
17111,3,1,4,,,,
136,15,33,48,,,,
1910,22,19,41,,,,
6103,48,50,98,,,,
16604,4,0,4,,,,
7136,13,5,18,,,,
11456,4,2,6,,,,
9079,8,57,65,,,,
7406,11,15,26,,,,
12015,32,107,139,,,,
10750,20,7,27,,,,
4131,15,24,39,,,,
9260,7,4,11,,,,
8940,25,41,66,,,,
17022,8,0,8,,,,
16467,12,15,27,,,,
15767,4,10,14,,,,
10996,106,5,111,,,,
17229,3,3,6,,,,
4342,51,17,68,,,,
11841,9,8,17,,,,
10603,16,14,30,,,,
12520,4,4,8,,,,
15797,1,4,5,,,,
13254,7,6,13,,,,
10782,7,8,15,,,,
8960,23,7,30,,,,
4853,1,2,3,,,,
3670,18,8,26,,,,
3362,12,2,14,,,,
7447,4,5,9,,,,
5623,53,5,58,,,,
17218,1,4,5,,,,
5588,1,5,6,,,,
14852,1,7,8,,,,
10214,2,8,10,,,,
12298,40,26,66,,,,
9101,94,5,99,,,,
12482,4,19,23,,,,
6812,29,54,83,,,,
7256,1,3,4,,,,
4972,7,0,7,,,,
14950,42,4,46,,,,
12859,6,3,9,,,,
11058,3,10,13,,,,
6631,6,3,9,,,,
877,14,0,14,,,,
11848,1,7,8,,,,
15820,19,3,22,,,,
2598,62,45,107,,,,
6861,10,3,13,,,,
5305,16,20,36,,,,
16542,2,6,8,,,,
13420,2,15,17,,,,
15131,70,26,96,,,,
14736,4,11,15,,,,
12143,2,10,12,,,,
14931,3,1,4,,,,
14276,7,0,7,,,,
7634,10,1,11,,,,
10383,2,5,7,,,,
131,39,432,471,,,,
7031,3,2,5,,,,
5175,3,3,6,,,,
9572,4,16,20,,,,
1427,97,57,154,,,,
6210,61,15,76,,,,
3334,16,2,18,,,,
4631,1,4,5,,,,
9693,5,1,6,,,,
16523,6,0,6,,,,
13334,1,0,1,,,,
5444,143,63,206,,,,
13333,19,2,21,,,,
9635,1,63,64,,,,
190,33,10,43,,,,
11911,19,4,23,,,,
1264,2,1,3,,,,
1574,42,103,145,,,,
11935,3,0,3,,,,
10071,9,8,17,,,,
12362,2,1,3,,,,
13699,11,9,20,,,,
4284,3,6,9,,,,
3538,8,5,13,,,,
4501,9,1,10,,,,
8927,11,15,26,,,,
5193,7,11,18,,,,
13545,5,29,34,,,,
10768,3,3,6,,,,
7635,21,0,21,,,,
15799,3,1,4,,,,
15061,6,13,19,,,,
12724,7,0,7,,,,
3164,9,0,9,,,,
8306,6,25,31,,,,
4659,13,2,15,,,,
6134,1,11,12,,,,
10637,11,4,15,,,,
12437,12,20,32,,,,
17886,2,4,6,,,,
7973,7,10,17,,,,
3915,45,11,56,,,,
17602,1,1,2,,,,
14815,8,1,9,,,,
4176,2,5,7,,,,
7867,20,1,21,,,,
3849,9,39,48,,,,
5041,46,79,125,,,,
4186,5,22,27,,,,
1265,16,18,34,,,,
10288,5,2,7,,,,
588,35,2,37,,,,
3789,13,1,14,,,,
17055,1,22,23,,,,
5151,7,0,7,,,,
15591,2,17,19,,,,
282,6,44,50,,,,
5871,4,70,74,,,,
5960,2,7,9,,,,
10128,6,1,7,,,,
9442,25,7,32,,,,
3147,4,8,12,,,,
4992,1,6,7,,,,
1430,48,89,137,,,,
7335,33,4,37,,,,
2885,13,14,27,,,,
6077,4,11,15,,,,
6903,18,24,42,,,,
12774,32,0,32,,,,
13871,2,2,4,,,,
3144,2,3,5,,,,
4795,10,59,69,,,,
7181,2,9,11,,,,
3946,2,29,31,,,,
15026,1,4,5,,,,
15062,5,8,13,,,,
2325,87,25,112,,,,
6434,14,78,92,,,,
16481,6,3,9,,,,
6029,4,0,4,,,,
12821,3,0,3,,,,
7912,17,85,102,,,,
2187,5,1,6,,,,
4762,2,2,4,,,,
3120,1,9,10,,,,
9232,3,15,18,,,,
650,2,91,93,,,,
8547,29,17,46,,,,
3143,26,24,50,,,,
8121,10,19,29,,,,
14110,7,8,15,,,,
883,1,0,1,,,,
8894,4,5,9,,,,
3490,5,0,5,,,,
16014,21,20,41,,,,
5439,163,57,220,,,,
4541,27,64,91,,,,
11607,22,13,35,,,,
4864,2,0,2,,,,
4289,3,160,163,,,,
8273,21,6,27,,,,
1110,47,9,56,,,,
13231,54,12,66,,,,
14104,15,2,17,,,,
3905,33,72,105,,,,
17520,5,2,7,,,,
6437,3,4,7,,,,
5622,4,5,9,,,,
8428,8,9,17,,,,
7012,7,4,11,,,,
16723,3,4,7,,,,
16347,3,17,20,,,,
6320,24,15,39,,,,
5130,5,4,9,,,,
4955,1,13,14,,,,
5083,100,21,121,,,,
15338,7,1,8,,,,
2195,23,13,36,,,,
4633,10,4,14,,,,
3984,11,2,13,,,,
12550,1,3,4,,,,
16733,2,4,6,,,,
2055,7,9,16,,,,
467,18,32,50,,,,
12390,13,17,30,,,,
4054,14,8,22,,,,
5376,121,26,147,,,,
9854,111,90,201,,,,
9219,4,6,10,,,,
12831,1,18,19,,,,
16588,1,1,2,,,,
12300,6,8,14,,,,
15837,10,7,17,,,,
4172,49,8,57,,,,
6925,3,4,7,,,,
14057,46,7,53,,,,
12283,1,2,3,,,,
7223,5,7,12,,,,
12879,3,2,5,,,,
12915,19,2,21,,,,
15070,6,0,6,,,,
2980,14,42,56,,,,
12813,4,0,4,,,,
12095,2,8,10,,,,
7914,118,16,134,,,,
7242,26,11,37,,,,
17222,6,1,7,,,,
1036,25,3,28,,,,
8239,16,74,90,,,,
5729,8,4,12,,,,
3968,14,17,31,,,,
5763,1,1,2,,,,
4947,5,13,18,,,,
10738,2,1,3,,,,
5422,2,210,212,,,,
13897,47,7,54,,,,
15420,4,22,26,,,,
5426,113,102,215,,,,
9454,55,19,74,,,,
13926,6,0,6,,,,
12848,3,1,4,,,,
15802,2,3,5,,,,
12973,6,13,19,,,,
9100,12,58,70,,,,
13940,6,11,17,,,,
11264,3,10,13,,,,
16097,8,9,17,,,,
8534,9,15,24,,,,
2226,23,8,31,,,,
523,2,3,5,,,,
12755,5,5,10,,,,
1194,19,6,25,,,,
5108,12,25,37,,,,
10672,12,0,12,,,,
1799,27,5,32,,,,
4254,19,12,31,,,,
15621,8,10,18,,,,
6932,7,11,18,,,,
1673,160,61,221,,,,
12906,6,1,7,,,,
4707,7,25,32,,,,
16792,4,9,13,,,,
2463,10,23,33,,,,
2744,12,14,26,,,,
719,16,9,25,,,,
17777,2,0,2,,,,
5861,6,8,14,,,,
14747,3,5,8,,,,
5198,19,34,53,,,,
1955,20,100,120,,,,
7226,5,0,5,,,,
10074,6,6,12,,,,
14686,60,2,62,,,,
16220,21,2,23,,,,
5032,4,23,27,,,,
9847,163,23,186,,,,
10018,12,2,14,,,,
4476,17,10,27,,,,
12346,10,56,66,,,,
14786,11,35,46,,,,
17326,21,10,31,,,,
8124,7,0,7,,,,
3831,13,1,14,,,,
9348,1,15,16,,,,
12024,11,3,14,,,,
1957,4,6,10,,,,
15746,1,4,5,,,,
10186,11,14,25,,,,
841,11,4,15,,,,
16684,2,4,6,,,,
11941,3,5,8,,,,
3257,31,70,101,,,,
9414,10,0,10,,,,
801,22,3,25,,,,
11022,4,0,4,,,,
12888,4,36,40,,,,
3125,1,3,4,,,,
1186,64,21,85,,,,
6699,33,90,123,,,,
12514,44,19,63,,,,
2958,4,1,5,,,,
7408,19,1,20,,,,
15651,2,43,45,,,,
7485,3,2,5,,,,
10297,1,7,8,,,,
15779,9,0,9,,,,
581,2,5,7,,,,
3799,3,0,3,,,,
10594,4,1,5,,,,
4985,2,4,6,,,,
15409,5,5,10,,,,
9007,47,45,92,,,,
5870,60,13,73,,,,
4959,20,11,31,,,,
10822,1,0,1,,,,
3098,1,2,3,,,,
6847,22,7,29,,,,
13726,3,6,9,,,,
10489,7,8,15,,,,
11146,3,2,5,,,,
5967,44,1,45,,,,
5937,14,10,24,,,,
9824,8,13,21,,,,
12328,17,5,22,,,,
17565,4,6,10,,,,
6221,4,19,23,,,,
17860,1,0,1,,,,
12257,1,2,3,,,,
17426,1,1,2,,,,
16156,5,11,16,,,,
8,6,19,25,,,,
12108,2,46,48,,,,
10812,4,9,13,,,,
6117,30,7,37,,,,
10577,1,0,1,,,,
11969,14,29,43,,,,
4410,2,13,15,,,,
2843,67,30,97,,,,
13191,48,12,60,,,,
9437,8,11,19,,,,
10516,52,3,55,,,,
6767,21,0,21,,,,
8010,5,26,31,,,,
14207,13,12,25,,,,
15182,4,0,4,,,,
2772,18,20,38,,,,
13588,15,3,18,,,,
5281,2,7,9,,,,
12291,16,15,31,,,,
13757,39,7,46,,,,
10190,21,10,31,,,,
13608,1,2,3,,,,
5703,8,2,10,,,,
6750,20,55,75,,,,
5850,1,13,14,,,,
4140,10,29,39,,,,
3064,2,50,52,,,,
812,5,7,12,,,,
14218,17,1,18,,,,
10840,3,8,11,,,,
6452,9,0,9,,,,
9172,4,6,10,,,,
11706,40,15,55,,,,
8571,31,35,66,,,,
16120,1,0,1,,,,
17859,1,0,1,,,,
13673,28,3,31,,,,
15262,3,3,6,,,,
5853,22,9,31,,,,
10411,1,4,5,,,,
8480,10,0,10,,,,
16101,1,10,11,,,,
17657,1,11,12,,,,
13205,88,0,88,,,,
14178,5,84,89,,,,
10683,7,19,26,,,,
5259,18,66,84,,,,
6467,16,0,16,,,,
13188,16,0,16,,,,
275,6,14,20,,,,
9630,4,7,11,,,,
7042,21,25,46,,,,
7603,16,4,20,,,,
405,4,0,4,,,,
361,12,4,16,,,,
13873,7,3,10,,,,
957,2,13,15,,,,
6927,5,38,43,,,,
526,4,7,11,,,,
12014,2,15,17,,,,
15390,25,27,52,,,,
12270,5,4,9,,,,
2140,2,0,2,,,,
10008,5,0,5,,,,
17631,6,0,6,,,,
15888,1,7,8,,,,
9160,3,0,3,,,,
1401,25,41,66,,,,
8924,10,9,19,,,,
1615,267,22,289,,,,
274,5,4,9,,,,
15327,3,1,4,,,,
13016,5,2,7,,,,
10468,3,2,5,,,,
1113,4,49,53,,,,
16534,2,4,6,,,,
11406,22,5,27,,,,
10254,5,5,10,,,,
10529,36,19,55,,,,
4856,6,5,11,,,,
6399,7,12,19,,,,
14541,58,17,75,,,,
9814,1,1,2,,,,
8493,11,6,17,,,,
17525,2,3,5,,,,
13902,6,2,8,,,,
6341,15,71,86,,,,
663,23,19,42,,,,
2845,63,31,94,,,,
485,4,20,24,,,,
9412,2,3,5,,,,
3373,1,11,12,,,,
11418,13,13,26,,,,
238,4,2,6,,,,
4821,13,15,28,,,,
11657,20,11,31,,,,
11055,34,25,59,,,,
317,11,0,11,,,,
15112,1,5,6,,,,
6104,46,7,53,,,,
2693,12,5,17,,,,
3211,5,15,20,,,,
6440,11,51,62,,,,
7077,6,17,23,,,,
1344,25,44,69,,,,
13446,5,1,6,,,,
669,100,9,109,,,,
8943,2,0,2,,,,
7534,3,8,11,,,,
17488,3,11,14,,,,
13102,4,25,29,,,,
16051,5,21,26,,,,
12068,10,10,20,,,,
11250,17,8,25,,,,
7580,10,7,17,,,,
15782,1,0,1,,,,
9048,2,1,3,,,,
13891,5,5,10,,,,
129,2,6,8,,,,
10727,32,3,35,,,,
1306,5,88,93,,,,
12542,6,16,22,,,,
10201,6,6,12,,,,
6760,39,16,55,,,,
3295,11,152,163,,,,
16742,2,1,3,,,,
5347,128,63,191,,,,
7824,43,13,56,,,,
165,7,41,48,,,,
5348,188,23,211,,,,
5509,19,162,181,,,,
3901,5,3,8,,,,
15716,6,2,8,,,,
13406,1,3,4,,,,
4747,4,8,12,,,,
1313,22,64,86,,,,
15966,9,14,23,,,,
2142,14,3,17,,,,
13642,2,8,10,,,,
4232,2,10,12,,,,
5278,10,13,23,,,,
10918,10,18,28,,,,
821,25,2,27,,,,
16013,11,11,22,,,,
7320,4,5,9,,,,
13571,15,0,15,,,,
5782,11,11,22,,,,
10387,15,2,17,,,,
3998,12,13,25,,,,
2657,20,21,41,,,,
10386,4,10,14,,,,
2470,7,6,13,,,,
13633,17,1,18,,,,
9806,6,4,10,,,,
17260,9,2,11,,,,
9319,14,12,26,,,,
4644,19,39,58,,,,
15171,7,19,26,,,,
14297,3,9,12,,,,
10668,8,6,14,,,,
9508,8,1,9,,,,
226,26,14,40,,,,
2742,13,1,14,,,,
11336,31,134,165,,,,
2800,3,5,8,,,,
7624,9,1,10,,,,
13259,2,0,2,,,,
6994,2,29,31,,,,
11801,19,15,34,,,,
17735,7,3,10,,,,
4611,7,13,20,,,,
10040,5,30,35,,,,
12931,7,2,9,,,,
6177,17,55,72,,,,
17383,10,2,12,,,,
10307,1,2,3,,,,
11180,7,14,21,,,,
5690,15,4,19,,,,
12215,2,20,22,,,,
4609,2,7,9,,,,
9794,7,7,14,,,,
7122,24,27,51,,,,
13066,3,0,3,,,,
9301,1,0,1,,,,
16633,2,18,20,,,,
13939,1,3,4,,,,
16895,15,6,21,,,,
6136,36,6,42,,,,
2942,35,18,53,,,,
15956,2,0,2,,,,
12914,2,1,3,,,,
2999,7,9,16,,,,
16431,1,4,5,,,,
13662,9,2,11,,,,
8334,5,21,26,,,,
10854,6,13,19,,,,
12195,6,1,7,,,,
8911,16,15,31,,,,
1074,20,4,24,,,,
11812,18,17,35,,,,
12645,8,8,16,,,,
2784,2,12,14,,,,
11390,10,18,28,,,,
15630,8,7,15,,,,
5417,189,17,206,,,,
17159,3,3,6,,,,
5491,19,6,25,,,,
14351,2,6,8,,,,
7132,11,7,18,,,,
15615,5,0,5,,,,
2393,15,41,56,,,,
408,161,42,203,,,,
14313,16,3,19,,,,
12874,2,13,15,,,,
16318,3,1,4,,,,
565,215,63,278,,,,
1171,28,86,114,,,,
2426,62,15,77,,,,
14363,15,19,34,,,,
8839,2,4,6,,,,
16057,6,20,26,,,,
16717,5,11,16,,,,
14885,15,17,32,,,,
10576,1,1,2,,,,
4391,1,2,3,,,,
7410,4,20,24,,,,
7047,15,41,56,,,,
13195,2,67,69,,,,
10843,6,8,14,,,,
9003,4,8,12,,,,
11302,27,17,44,,,,
6887,22,10,32,,,,
471,5,3,8,,,,
4565,1,28,29,,,,
2827,26,16,42,,,,
7424,1,8,9,,,,
10352,7,1,8,,,,
8761,1,4,5,,,,
15867,7,7,14,,,,
1909,50,37,87,,,,
15906,5,0,5,,,,
5781,10,31,41,,,,
1666,54,21,75,,,,
11840,3,0,3,,,,
8879,8,6,14,,,,
11499,31,19,50,,,,
7650,7,23,30,,,,
17772,3,2,5,,,,
3615,53,18,71,,,,
7338,3,2,5,,,,
17526,7,1,8,,,,
12094,11,17,28,,,,
2588,1,3,4,,,,
10341,3,6,9,,,,
11072,8,16,24,,,,
15087,14,0,14,,,,
15512,19,6,25,,,,
1423,171,18,189,,,,
3854,4,2,6,,,,
10476,76,3,79,,,,
14828,5,1,6,,,,
6944,4,3,7,,,,
15865,6,5,11,,,,
2580,10,17,27,,,,
11129,32,3,35,,,,
9202,2,6,8,,,,
12106,13,0,13,,,,
13971,17,15,32,,,,
12895,12,0,12,,,,
9731,3,6,9,,,,
9067,101,56,157,,,,
9966,37,8,45,,,,
16125,4,2,6,,,,
17284,5,3,8,,,,
6872,80,0,80,,,,
9577,2,8,10,,,,
10076,54,2,56,,,,
2645,6,45,51,,,,
14812,2,0,2,,,,
1772,20,2,22,,,,
324,5,4,9,,,,
6151,1,0,1,,,,
16332,2,7,9,,,,
5115,7,3,10,,,,
3938,58,65,123,,,,
7337,2,2,4,,,,
713,94,17,111,,,,
5901,20,32,52,,,,
2443,136,51,187,,,,
6566,4,13,17,,,,
17676,4,8,12,,,,
10739,1,1,2,,,,
17652,2,2,4,,,,
4242,1,0,1,,,,
7183,5,1,6,,,,
9121,1,9,10,,,,
17036,5,9,14,,,,
14220,14,5,19,,,,
4650,1,4,5,,,,
12528,22,36,58,,,,
14744,1,7,8,,,,
9867,36,19,55,,,,
6864,41,3,44,,,,
13832,5,1,6,,,,
2521,2,41,43,,,,
9215,18,2,20,,,,
8033,11,2,13,,,,
9916,40,2,42,,,,
13244,10,11,21,,,,
12982,5,6,11,,,,
12621,2,1,3,,,,
1285,19,50,69,,,,
15151,2,14,16,,,,
2870,34,7,41,,,,
12739,4,1,5,,,,
6407,21,3,24,,,,
16432,1,4,5,,,,
5351,95,83,178,,,,
5182,3,7,10,,,,
15546,3,2,5,,,,
9340,4,24,28,,,,
10823,3,4,7,,,,
14889,14,10,24,,,,
11822,3,7,10,,,,
14566,48,21,69,,,,
982,2,3,5,,,,
8735,1,6,7,,,,
1625,179,52,231,,,,
12313,22,21,43,,,,
16626,2,11,13,,,,
12609,7,12,19,,,,
6441,24,71,95,,,,
2565,21,3,24,,,,
15006,4,1,5,,,,
3422,8,0,8,,,,
15835,6,5,11,,,,
181,340,25,365,,,,
13770,14,49,63,,,,
4152,22,24,46,,,,
3368,80,11,91,,,,
7640,2,31,33,,,,
17078,8,1,9,,,,
1457,6,4,10,,,,
9280,5,6,11,,,,
7886,4,0,4,,,,
13073,2,0,2,,,,
14465,8,0,8,,,,
4299,87,43,130,,,,
14249,2,2,4,,,,
9796,16,7,23,,,,
15724,5,0,5,,,,
1821,27,186,213,,,,
10957,13,1,14,,,,
1167,2,0,2,,,,
2774,3,1,4,,,,
17593,2,10,12,,,,
5560,21,19,40,,,,
13558,35,12,47,,,,
11283,6,9,15,,,,
16781,10,0,10,,,,
17793,4,1,5,,,,
13805,1,19,20,,,,
14595,32,2,34,,,,
12486,6,37,43,,,,
7632,47,2,49,,,,
11308,3,0,3,,,,
16248,2,3,5,,,,
137,52,86,138,,,,
16003,20,24,44,,,,
10658,20,3,23,,,,
7501,9,8,17,,,,
14768,7,3,10,,,,
4328,1,15,16,,,,
8873,3,13,16,,,,
4467,12,4,16,,,,
10976,1,0,1,,,,
8723,9,7,16,,,,
8377,2,8,10,,,,
7890,26,1,27,,,,
12027,2,2,4,,,,
13167,14,47,61,,,,
9062,68,26,94,,,,
12066,16,7,23,,,,
11869,4,4,8,,,,
158,328,44,372,,,,
15666,2,4,6,,,,
1516,6,3,9,,,,
13847,4,3,7,,,,
11769,19,0,19,,,,
15198,1,4,5,,,,
5437,21,147,168,,,,
6004,3,10,13,,,,
14462,1,2,3,,,,
16540,2,1,3,,,,
6238,50,43,93,,,,
10885,14,8,22,,,,
6533,28,28,56,,,,
2178,5,2,7,,,,
568,19,18,37,,,,
2920,9,5,14,,,,
13845,1,9,10,,,,
6403,2,6,8,,,,
10471,31,1,32,,,,
8050,1,0,1,,,,
15169,8,0,8,,,,
17413,2,0,2,,,,
3253,48,76,124,,,,
10220,14,13,27,,,,
4538,20,21,41,,,,
9405,1,31,32,,,,
11279,1,2,3,,,,
13544,21,0,21,,,,
14237,2,7,9,,,,
6247,88,115,203,,,,
10485,19,30,49,,,,
5244,10,24,34,,,,
1331,26,2,28,,,,
10608,2,10,12,,,,
2043,6,7,13,,,,
573,22,2,24,,,,
9917,13,5,18,,,,
891,30,2,32,,,,
15003,8,0,8,,,,
15774,5,3,8,,,,
1059,6,9,15,,,,
634,14,31,45,,,,
2540,12,4,16,,,,
13880,16,2,18,,,,
3563,2,1,3,,,,
2916,19,29,48,,,,
5392,46,75,121,,,,
551,73,126,199,,,,
537,1,86,87,,,,
5499,24,163,187,,,,
6280,7,22,29,,,,
457,14,4,18,,,,
16201,15,3,18,,,,
14199,30,2,32,,,,
3820,8,32,40,,,,
3533,9,49,58,,,,
14945,1,0,1,,,,
15754,10,5,15,,,,
17103,3,2,5,,,,
12992,1,8,9,,,,
603,13,5,18,,,,
3404,23,38,61,,,,
11571,2,2,4,,,,
6985,11,1,12,,,,
14980,14,31,45,,,,
1662,57,46,103,,,,
2748,7,3,10,,,,
12624,2,3,5,,,,
13937,11,19,30,,,,
1505,7,3,10,,,,
7416,3,6,9,,,,
14938,11,8,19,,,,
4620,9,6,15,,,,
7186,1,0,1,,,,
7289,16,47,63,,,,
9962,35,12,47,,,,
4258,11,34,45,,,,
3020,21,5,26,,,,
16680,5,8,13,,,,
6596,3,12,15,,,,
8406,1,4,5,,,,
10759,4,10,14,,,,
13748,3,11,14,,,,
2737,12,26,38,,,,
545,72,48,120,,,,
4156,10,15,25,,,,
978,4,7,11,,,,
966,5,2,7,,,,
2716,27,60,87,,,,
2328,16,106,122,,,,
2283,5,0,5,,,,
13783,1,2,3,,,,
11292,2,0,2,,,,
2925,3,3,6,,,,
2902,92,64,156,,,,
8643,2,6,8,,,,
8605,35,8,43,,,,
14753,6,0,6,,,,
8732,2,24,26,,,,
11248,3,2,5,,,,
9943,2,1,3,,,,
1588,15,66,81,,,,
10126,2,4,6,,,,
7029,2,0,2,,,,
8903,51,3,54,,,,
9714,3,0,3,,,,
2986,46,26,72,,,,
10743,2,5,7,,,,
1655,28,40,68,,,,
666,75,40,115,,,,
2149,8,8,16,,,,
15188,10,0,10,,,,
10878,12,9,21,,,,
17454,3,30,33,,,,
800,77,30,107,,,,
14066,17,8,25,,,,
6623,16,7,23,,,,
1282,1,6,7,,,,
5604,1,13,14,,,,
831,3,2,5,,,,
10853,2,2,4,,,,
13452,1,2,3,,,,
15298,14,21,35,,,,
17136,12,3,15,,,,
1886,21,63,84,,,,
3302,4,62,66,,,,
12498,101,16,117,,,,
2928,13,6,19,,,,
1867,4,9,13,,,,
8576,22,2,24,,,,
2809,1,5,6,,,,
12451,5,32,37,,,,
17667,1,4,5,,,,
17224,6,6,12,,,,
4710,105,6,111,,,,
13251,6,8,14,,,,
6961,27,34,61,,,,
9291,3,10,13,,,,
11369,1,0,1,,,,
14004,3,5,8,,,,
8730,4,0,4,,,,
3202,22,11,33,,,,
2562,19,7,26,,,,
15704,5,16,21,,,,
1529,422,5,427,,,,
9596,15,3,18,,,,
10560,7,9,16,,,,
8740,2,5,7,,,,
212,13,0,13,,,,
16562,20,5,25,,,,
17608,9,1,10,,,,
5976,11,19,30,,,,
6986,4,4,8,,,,
8182,2,14,16,,,,
11519,8,9,17,,,,
579,21,48,69,,,,
16656,2,4,6,,,,
13736,4,5,9,,,,
9282,2,10,12,,,,
2729,1,8,9,,,,
15608,15,3,18,,,,
147,131,124,255,,,,
8660,32,45,77,,,,
1460,2,5,7,,,,
7356,1,2,3,,,,
997,7,15,22,,,,
8381,11,2,13,,,,
11918,9,29,38,,,,
927,25,1,26,,,,
13644,38,11,49,,,,
12178,14,2,16,,,,
12238,36,13,49,,,,
16175,9,4,13,,,,
2015,45,5,50,,,,
16480,14,3,17,,,,
1648,1,3,4,,,,
8953,2,27,29,,,,
12658,11,8,19,,,,
3621,2,1,3,,,,
1311,112,142,254,,,,
5689,23,1,24,,,,
10455,1,1,2,,,,
5368,5,214,219,,,,
5863,25,23,48,,,,
1778,428,23,451,,,,
7574,23,4,27,,,,
12470,12,10,22,,,,
10191,2,19,21,,,,
15,5,10,15,,,,
10971,6,2,8,,,,
17864,2,0,2,,,,
11520,1,9,10,,,,
4456,4,0,4,,,,
12091,12,4,16,,,,
11557,1,23,24,,,,
2940,19,36,55,,,,
16897,2,0,2,,,,
16112,2,0,2,,,,
7096,3,10,13,,,,
2528,5,18,23,,,,
13430,1,3,4,,,,
13093,46,35,81,,,,
10665,11,13,24,,,,
14309,7,1,8,,,,
5834,23,8,31,,,,
6009,1,36,37,,,,
6993,5,6,11,,,,
2507,9,25,34,,,,
8483,3,2,5,,,,
13723,10,56,66,,,,
6798,2,1,3,,,,
5202,1,6,7,,,,
12422,5,5,10,,,,
5892,21,1,22,,,,
554,10,22,32,,,,
14731,6,29,35,,,,
6397,1,4,5,,,,
9277,33,6,39,,,,
12357,72,3,75,,,,
11925,8,11,19,,,,
7717,1,39,40,,,,
2336,88,24,112,,,,
4793,51,4,55,,,,
12509,3,36,39,,,,
17344,4,0,4,,,,
13513,18,4,22,,,,
9515,1,6,7,,,,
121,22,90,112,,,,
12578,17,6,23,,,,
2068,3,5,8,,,,
15356,3,9,12,,,,
79,25,31,56,,,,
17810,1,3,4,,,,
16444,9,9,18,,,,
11625,12,25,37,,,,
16421,5,2,7,,,,
7046,21,67,88,,,,
8978,35,21,56,,,,
3618,10,12,22,,,,
12426,2,2,4,,,,
12101,3,4,7,,,,
5641,23,41,64,,,,
6941,14,11,25,,,,
2381,24,68,92,,,,
1270,9,22,31,,,,
685,18,71,89,,,,
7138,9,11,20,,,,
31,3,19,22,,,,
10884,13,7,20,,,,
4839,6,1,7,,,,
2983,22,0,22,,,,
17350,2,1,3,,,,
17227,4,11,15,,,,
9862,22,11,33,,,,
6995,1,3,4,,,,
12135,3,16,19,,,,
12822,10,7,17,,,,
5142,8,18,26,,,,
6543,7,0,7,,,,
710,32,52,84,,,,
9231,9,1,10,,,,
178,80,26,106,,,,
12962,2,3,5,,,,
13387,13,19,32,,,,
4890,5,0,5,,,,
1589,34,9,43,,,,
8825,3,0,3,,,,
6012,38,10,48,,,,
8801,64,13,77,,,,
12745,30,6,36,,,,
9574,18,47,65,,,,
10139,1,10,11,,,,
17313,3,4,7,,,,
16284,5,3,8,,,,
13456,1,17,18,,,,
2272,88,22,110,,,,
2458,16,3,19,,,,
15386,1,14,15,,,,
4244,1,1,2,,,,
16457,1,1,2,,,,
6739,8,107,115,,,,
8786,71,37,108,,,,
8045,7,3,10,,,,
4144,20,45,65,,,,
1521,12,2,14,,,,
14610,23,17,40,,,,
6692,25,7,32,,,,
10696,58,17,75,,,,
5806,6,4,10,,,,
17648,5,3,8,,,,
10289,3,4,7,,,,
743,51,55,106,,,,
124,31,78,109,,,,
9655,6,0,6,,,,
14670,6,45,51,,,,
11764,10,5,15,,,,
17710,2,5,7,,,,
5997,8,10,18,,,,
3521,14,3,17,,,,
7562,32,23,55,,,,
5627,15,46,61,,,,
12569,8,3,11,,,,
8910,5,3,8,,,,
3739,9,2,11,,,,
8942,11,3,14,,,,
12286,4,7,11,,,,
11354,2,1,3,,,,
381,3,34,37,,,,
16681,2,5,7,,,,
518,7,2,9,,,,
1005,5,8,13,,,,
5194,24,3,27,,,,
16988,7,1,8,,,,
4226,6,6,12,,,,
12485,1,6,7,,,,
15702,2,1,3,,,,
6800,42,10,52,,,,
4256,5,10,15,,,,
2346,34,24,58,,,,
11341,104,65,169,,,,
230,28,6,34,,,,
215,12,13,25,,,,
2172,2,2,4,,,,
14683,1,3,4,,,,
11340,90,69,159,,,,
8919,2,0,2,,,,
11210,8,3,11,,,,
7931,10,2,12,,,,
7041,18,6,24,,,,
5664,1,0,1,,,,
3441,2,22,24,,,,
8845,2,5,7,,,,
8172,26,99,125,,,,
7188,25,14,39,,,,
5562,3,0,3,,,,
4188,4,20,24,,,,
6607,1,10,11,,,,
12111,1,10,11,,,,
5434,50,34,84,,,,
11636,10,3,13,,,,
11584,4,0,4,,,,
16322,4,10,14,,,,
1607,11,0,11,,,,
14646,6,7,13,,,,
7904,62,11,73,,,,
1039,6,31,37,,,,
10209,4,0,4,,,,
15863,2,10,12,,,,
10628,19,4,23,,,,
1530,29,4,33,,,,
14243,5,4,9,,,,
7198,1,13,14,,,,
1839,8,42,50,,,,
5812,10,14,24,,,,
12297,3,19,22,,,,
16068,5,5,10,,,,
11838,2,18,20,,,,
15943,10,5,15,,,,
9978,81,2,83,,,,
10437,9,6,15,,,,
5461,135,67,202,,,,
1102,1,2,3,,,,
17867,4,0,4,,,,
2305,71,97,168,,,,
12695,9,8,17,,,,
5914,4,2,6,,,,
7984,13,56,69,,,,
4605,23,5,28,,,,
5674,11,10,21,,,,
11480,3,13,16,,,,
4657,2,5,7,,,,
16775,4,1,5,,,,
7074,31,18,49,,,,
5872,3,39,42,,,,
9488,2,1,3,,,,
3736,8,2,10,,,,
4623,11,25,36,,,,
7067,9,10,19,,,,
6612,9,2,11,,,,
17205,14,8,22,,,,
9391,5,0,5,,,,
16291,2,0,2,,,,
6241,12,5,17,,,,
4944,2,14,16,,,,
14125,1,0,1,,,,
3252,90,89,179,,,,
12368,25,6,31,,,,
7241,117,10,127,,,,
8103,12,2,14,,,,
11436,27,18,45,,,,
7815,15,9,24,,,,
11108,30,13,43,,,,
4930,9,7,16,,,,
17728,9,0,9,,,,
14050,1,40,41,,,,
10816,16,1,17,,,,
2627,39,36,75,,,,
9370,3,0,3,,,,
14384,11,7,18,,,,
3710,60,35,95,,,,
6394,2,3,5,,,,
9275,22,9,31,,,,
1091,13,3,16,,,,
9946,8,0,8,,,,
363,2,3,5,,,,
7373,17,70,87,,,,
6409,62,2,64,,,,
2898,2,14,16,,,,
2857,34,25,59,,,,
1470,58,47,105,,,,
8622,11,7,18,,,,
10761,5,18,23,,,,
15517,3,2,5,,,,
4409,7,2,9,,,,
963,3,2,5,,,,
1626,43,432,475,,,,
3237,66,1,67,,,,
5266,28,12,40,,,,
849,2,23,25,,,,
1184,5,1,6,,,,
722,118,15,133,,,,
10385,3,5,8,,,,
9330,10,34,44,,,,
4658,1,10,11,,,,
1508,7,7,14,,,,
16874,18,4,22,,,,
3890,22,23,45,,,,
9967,53,0,53,,,,
3457,3,4,7,,,,
3045,46,12,58,,,,
91,68,115,183,,,,
1817,31,0,31,,,,
6585,26,5,31,,,,
7533,52,9,61,,,,
15373,5,8,13,,,,
7089,30,35,65,,,,
3681,6,11,17,,,,
12142,6,5,11,,,,
8086,3,0,3,,,,
6031,4,7,11,,,,
9337,19,22,41,,,,
10240,2,24,26,,,,
6978,17,10,27,,,,
3219,4,0,4,,,,
5095,3,4,7,,,,
9517,13,9,22,,,,
11543,3,6,9,,,,
16294,7,7,14,,,,
10474,17,29,46,,,,
16006,16,33,49,,,,
8972,12,40,52,,,,
14508,17,27,44,,,,
9798,26,2,28,,,,
15167,7,1,8,,,,
9599,82,20,102,,,,
4101,63,37,100,,,,
13396,10,9,19,,,,
12780,1,7,8,,,,
16164,2,8,10,,,,
12505,3,0,3,,,,
2032,1,1,2,,,,
17582,1,5,6,,,,
14272,1,11,12,,,,
10979,3,2,5,,,,
5670,2,1,3,,,,
13634,3,1,4,,,,
15305,6,13,19,,,,
3180,2,15,17,,,,
17613,1,0,1,,,,
16012,13,48,61,,,,
5753,1,1,2,,,,
13745,3,10,13,,,,
9434,12,1,13,,,,
14049,14,16,30,,,,
1103,4,0,4,,,,
382,16,5,21,,,,
3603,9,0,9,,,,
12133,4,15,19,,,,
8926,1,0,1,,,,
10626,36,6,42,,,,
10354,14,1,15,,,,
14832,8,7,15,,,,
4999,19,10,29,,,,
6000,13,3,16,,,,
3171,74,23,97,,,,
1730,11,9,20,,,,
6742,39,1,40,,,,
7630,18,25,43,,,,
279,5,4,9,,,,
4568,29,5,34,,,,
5876,6,26,32,,,,
8057,4,4,8,,,,
1532,12,43,55,,,,
5904,40,47,87,,,,
3307,21,113,134,,,,
16915,2,7,9,,,,
14460,14,0,14,,,,
14195,2,3,5,,,,
3696,9,15,24,,,,
3729,13,16,29,,,,
8748,3,1,4,,,,
11738,12,23,35,,,,
2730,5,34,39,,,,
7884,27,7,34,,,,
4351,2,2,4,,,,
11040,36,51,87,,,,
14756,9,11,20,,,,
5957,15,8,23,,,,
1856,14,9,23,,,,
15635,4,25,29,,,,
11782,7,39,46,,,,
7729,5,13,18,,,,
6150,6,10,16,,,,
17592,13,2,15,,,,
12285,3,6,9,,,,
8153,19,72,91,,,,
2501,4,0,4,,,,
8016,13,17,30,,,,
16264,4,11,15,,,,
1983,5,6,11,,,,
10511,5,51,56,,,,
12525,19,10,29,,,,
16640,21,10,31,,,,
2796,6,0,6,,,,
2856,93,72,165,,,,
8274,4,5,9,,,,
4194,3,20,23,,,,
1928,13,7,20,,,,
17485,1,1,2,,,,
2227,6,89,95,,,,
2101,3,0,3,,,,
8531,32,37,69,,,,
3514,4,9,13,,,,
4197,58,34,92,,,,
13680,4,3,7,,,,
13849,19,4,23,,,,
10180,7,32,39,,,,
3935,51,17,68,,,,
4600,9,4,13,,,,
15399,46,10,56,,,,
4203,29,14,43,,,,
347,8,13,21,,,,
15408,8,37,45,,,,
10980,1,1,2,,,,
1273,9,1,10,,,,
2921,14,2,16,,,,
12519,33,21,54,,,,
12182,19,11,30,,,,
847,2,1,3,,,,
3118,10,4,14,,,,
10675,5,18,23,,,,
2499,3,8,11,,,,
1147,9,7,16,,,,
13092,39,8,47,,,,
4026,3,2,5,,,,
1188,2,21,23,,,,
5500,35,59,94,,,,
560,32,34,66,,,,
16569,5,7,12,,,,
3275,1,20,21,,,,
13743,5,2,7,,,,
6040,2,2,4,,,,
2287,18,52,70,,,,
14867,1,1,2,,,,
8513,6,5,11,,,,
1946,5,8,13,,,,
10346,8,18,26,,,,
5304,16,6,22,,,,
6217,91,27,118,,,,
15616,7,4,11,,,,
5480,131,22,153,,,,
12141,9,5,14,,,,
12584,3,0,3,,,,
6408,6,14,20,,,,
14248,2,1,3,,,,
5314,24,5,29,,,,
7976,1,6,7,,,,
3458,1,1,2,,,,
176,455,78,533,,,,
14550,10,25,35,,,,
751,39,76,115,,,,
9570,28,8,36,,,,
4278,49,8,57,,,,
9107,13,32,45,,,,
13342,4,3,7,,,,
8291,13,22,35,,,,
13989,8,7,15,,,,
2448,85,74,159,,,,
2453,60,17,77,,,,
10923,12,7,19,,,,
10422,2,0,2,,,,
11214,5,2,7,,,,
13821,6,6,12,,,,
16060,8,33,41,,,,
16398,4,13,17,,,,
202,12,12,24,,,,
8445,21,31,52,,,,
16092,13,17,30,,,,
9043,7,4,11,,,,
3287,35,26,61,,,,
15148,13,2,15,,,,
1060,13,14,27,,,,
17668,1,1,2,,,,
8369,11,6,17,,,,
17879,3,0,3,,,,
6736,15,69,84,,,,
13713,3,13,16,,,,
3509,8,13,21,,,,
12727,5,8,13,,,,
11320,45,121,166,,,,
9058,3,12,15,,,,
14639,5,1,6,,,,
4077,8,107,115,,,,
7500,9,31,40,,,,
14348,3,2,5,,,,
8242,44,44,88,,,,
6311,2,27,29,,,,
10160,1,3,4,,,,
10874,13,9,22,,,,
1191,2,1,3,,,,
6428,32,22,54,,,,
17784,9,2,11,,,,
312,3,5,8,,,,
15911,1,24,25,,,,
14304,17,0,17,,,,
4588,1,4,5,,,,
9241,8,47,55,,,,
676,76,242,318,,,,
10886,1,16,17,,,,
11716,16,25,41,,,,
11332,13,164,177,,,,
820,30,17,47,,,,
281,12,7,19,,,,
933,4,0,4,,,,
10009,7,5,12,,,,
12891,1,3,4,,,,
16696,6,16,22,,,,
15997,7,57,64,,,,
1410,193,28,221,,,,
3489,10,40,50,,,,
4777,5,4,9,,,,
4028,4,2,6,,,,
5856,15,6,21,,,,
16695,18,11,29,,,,
11650,9,6,15,,,,
7878,6,1,7,,,,
12189,2,1,3,,,,
1991,17,3,20,,,,
2468,16,1,17,,,,
3065,10,11,21,,,,
2839,14,61,75,,,,
8007,7,2,9,,,,
10022,12,6,18,,,,
13088,3,13,16,,,,
15892,1,9,10,,,,
4453,25,47,72,,,,
14344,5,3,8,,,,
7517,85,114,199,,,,
11712,7,19,26,,,,
16152,7,20,27,,,,
11758,1,4,5,,,,
2382,39,31,70,,,,
15098,10,7,17,,,,
2761,1,3,4,,,,
7033,18,6,24,,,,
5105,1,2,3,,,,
13561,1,2,3,,,,
16478,11,10,21,,,,
7065,10,11,21,,,,
15532,5,2,7,,,,
8284,2,9,11,,,,
16281,4,8,12,,,,
11631,4,8,12,,,,
12606,6,6,12,,,,
6955,4,5,9,,,,
13854,1,1,2,,,,
17658,3,1,4,,,,
14746,1,9,10,,,,
7361,4,0,4,,,,
14877,4,2,6,,,,
7543,185,42,227,,,,
3044,17,8,25,,,,
13288,3,2,5,,,,
13767,3,0,3,,,,
6475,25,23,48,,,,
5059,5,16,21,,,,
15732,3,6,9,,,,
16430,7,0,7,,,,
10301,5,7,12,,,,
8385,5,3,8,,,,
265,6,4,10,,,,
6626,5,24,29,,,,
2599,40,200,240,,,,
7502,8,18,26,,,,
16312,1,7,8,,,,
9997,12,8,20,,,,
12541,73,51,124,,,,
15162,8,3,11,,,,
17846,6,0,6,,,,
6917,18,6,24,,,,
9998,1,17,18,,,,
14714,7,8,15,,,,
9551,3,7,10,,,,
6900,5,130,135,,,,
7800,14,2,16,,,,
2203,9,8,17,,,,
3974,16,19,35,,,,
16925,1,8,9,,,,
4894,1,6,7,,,,
3778,1,8,9,,,,
16851,6,1,7,,,,
280,48,53,101,,,,
3835,18,6,24,,,,
3910,11,5,16,,,,
4751,19,13,32,,,,
11211,6,7,13,,,,
13470,10,1,11,,,,
7348,2,24,26,,,,
15176,12,1,13,,,,
14707,7,14,21,,,,
2974,6,71,77,,,,
14912,18,1,19,,,,
17549,4,3,7,,,,
10650,3,0,3,,,,
4676,25,20,45,,,,
13689,2,4,6,,,,
10964,11,15,26,,,,
4430,18,3,21,,,,
8628,32,32,64,,,,
9923,1,7,8,,,,
337,3,0,3,,,,
5107,1,1,2,,,,
9112,4,3,7,,,,
8005,21,13,34,,,,
10258,3,4,7,,,,
13793,8,1,9,,,,
17796,4,5,9,,,,
16076,24,10,34,,,,
13216,16,9,25,,,,
3476,111,64,175,,,,
3473,15,6,21,,,,
9690,14,1,15,,,,
4359,48,31,79,,,,
6371,13,12,25,,,,
1922,36,21,57,,,,
11534,43,35,78,,,,
12194,5,3,8,,,,
11126,1,0,1,,,,
4712,26,15,41,,,,
14574,35,32,67,,,,
9033,4,14,18,,,,
16530,20,3,23,,,,
8671,1,8,9,,,,
4927,9,14,23,,,,
15000,9,4,13,,,,
5875,22,16,38,,,,
14294,13,3,16,,,,
11170,7,12,19,,,,
17046,15,18,33,,,,
1481,14,1,15,,,,
9986,12,15,27,,,,
17257,23,8,31,,,,
7915,14,27,41,,,,
414,2,21,23,,,,
8656,46,3,49,,,,
5608,3,4,7,,,,
10723,6,0,6,,,,
4357,37,26,63,,,,
11563,5,2,7,,,,
7692,17,14,31,,,,
6660,15,7,22,,,,
9686,8,4,12,,,,
17191,3,8,11,,,,
5534,9,10,19,,,,
9805,8,4,12,,,,
14255,11,0,11,,,,
15653,3,10,13,,,,
13877,7,0,7,,,,
30,2,1,3,,,,
13343,2,3,5,,,,
17539,3,0,3,,,,
3678,58,13,71,,,,
13868,9,7,16,,,,
13153,3,6,9,,,,
16737,10,0,10,,,,
15569,11,1,12,,,,
6643,4,65,69,,,,
14679,4,6,10,,,,
4237,7,31,38,,,,
11644,4,5,9,,,,
11257,16,0,16,,,,
1082,2,2,4,,,,
1760,133,177,310,,,,
6849,87,24,111,,,,
6076,4,0,4,,,,
6716,45,8,53,,,,
8802,37,43,80,,,,
11298,8,21,29,,,,
15987,11,0,11,,,,
11957,40,33,73,,,,
704,45,58,103,,,,
11522,3,9,12,,,,
13143,19,3,22,,,,
4933,5,0,5,,,,
16435,3,0,3,,,,
13698,3,4,7,,,,
631,12,30,42,,,,
17825,7,0,7,,,,
11762,53,25,78,,,,
9961,18,1,19,,,,
16575,1,6,7,,,,
14794,4,12,16,,,,
16951,8,6,14,,,,
334,19,3,22,,,,
14177,21,4,25,,,,
11324,88,75,163,,,,
17054,2,2,4,,,,
8059,3,7,10,,,,
15522,6,3,9,,,,
1990,37,10,47,,,,
6727,5,0,5,,,,
13181,120,28,148,,,,
8450,1,2,3,,,,
15247,2,0,2,,,,
9928,3,6,9,,,,
14643,3,0,3,,,,
11027,1,1,2,,,,
3487,20,5,25,,,,
5886,28,27,55,,,,
17040,16,15,31,,,,
4,30,12,42,,,,
2398,41,28,69,,,,
4438,28,7,35,,,,
8928,2,0,2,,,,
2929,16,34,50,,,,
1142,9,1,10,,,,
7719,114,5,119,,,,
14647,5,10,15,,,,
11798,20,6,26,,,,
2243,18,1,19,,,,
12083,16,0,16,,,,
6390,11,2,13,,,,
14920,3,5,8,,,,
14627,8,15,23,,,,
13606,2,8,10,,,,
6112,15,12,27,,,,
10026,206,144,350,,,,
7647,21,0,21,,,,
8186,15,25,40,,,,
4280,87,11,98,,,,
6926,3,1,4,,,,
9046,20,0,20,,,,
9377,12,4,16,,,,
5264,80,9,89,,,,
1001,29,2,31,,,,
13465,9,4,13,,,,
8866,1,0,1,,,,
6326,63,36,99,,,,
2853,4,10,14,,,,
8206,30,14,44,,,,
16611,3,1,4,,,,
14428,6,5,11,,,,
12216,8,2,10,,,,
1025,20,28,48,,,,
13815,4,4,8,,,,
15385,59,0,59,,,,
10450,1,31,32,,,,
15114,3,1,4,,,,
11770,7,14,21,,,,
6172,28,27,55,,,,
6683,81,36,117,,,,
661,19,193,212,,,,
9186,1,5,6,,,,
7360,5,0,5,,,,
12176,2,3,5,,,,
3623,42,1,43,,,,
266,20,15,35,,,,
5565,2,32,34,,,,
10789,4,13,17,,,,
2939,2,11,13,,,,
6749,5,26,31,,,,
6923,7,8,15,,,,
6416,15,70,85,,,,
6297,19,30,49,,,,
4664,57,21,78,,,,
6356,3,2,5,,,,
14866,1,0,1,,,,
3671,11,9,20,,,,
3076,5,2,7,,,,
7882,3,0,3,,,,
4784,5,35,40,,,,
5829,6,46,52,,,,
3453,1,4,5,,,,
2502,2,3,5,,,,
9878,1,5,6,,,,
349,21,4,25,,,,
2451,54,29,83,,,,
4842,13,6,19,,,,
1895,65,52,117,,,,
15965,9,9,18,,,,
5460,26,177,203,,,,
13639,6,13,19,,,,
11473,2,10,12,,,,
15536,1,2,3,,,,
11161,15,2,17,,,,
12373,15,3,18,,,,
15676,3,1,4,,,,
1759,17,28,45,,,,
9856,158,27,185,,,,
7930,9,7,16,,,,
2270,5,19,24,,,,
4057,6,40,46,,,,
7114,4,12,16,,,,
3101,6,3,9,,,,
12225,1,1,2,,,,
8678,8,1,9,,,,
7292,1,0,1,,,,
1125,5,0,5,,,,
182,15,53,68,,,,
16461,1,3,4,,,,
4182,9,12,21,,,,
4118,2,18,20,,,,
2892,28,12,40,,,,
2723,211,64,275,,,,
10537,8,5,13,,,,
17552,2,2,4,,,,
13046,19,12,31,,,,
16820,3,0,3,,,,
9178,5,0,5,,,,
2726,138,9,147,,,,
4446,3,11,14,,,,
13164,11,5,16,,,,
11668,64,18,82,,,,
11222,8,3,11,,,,
9908,38,1,39,,,,
7143,12,5,17,,,,
5416,161,22,183,,,,
12680,2,13,15,,,,
16616,4,12,16,,,,
8632,2,4,6,,,,
9772,6,5,11,,,,
11231,3,0,3,,,,
863,35,46,81,,,,
17816,2,3,5,,,,
13203,9,65,74,,,,
7458,4,5,9,,,,
11169,2,0,2,,,,
6398,45,16,61,,,,
17701,1,3,4,,,,
6225,47,180,227,,,,
14886,7,2,9,,,,
262,1,3,4,,,,
14403,1,6,7,,,,
11833,19,8,27,,,,
7818,8,7,15,,,,
3034,9,20,29,,,,
10864,3,1,4,,,,
9631,5,3,8,,,,
5386,34,181,215,,,,
15813,19,0,19,,,,
16087,47,3,50,,,,
15475,6,5,11,,,,
2673,4,47,51,,,,
589,15,18,33,,,,
15364,11,3,14,,,,
6779,16,2,18,,,,
11592,1,0,1,,,,
8482,13,4,17,,,,
7968,11,17,28,,,,
17711,1,7,8,,,,
5332,1,22,23,,,,
12491,47,40,87,,,,
6468,7,6,13,,,,
13090,11,7,18,,,,
8816,1,0,1,,,,
16608,5,2,7,,,,
1753,128,67,195,,,,
2622,68,42,110,,,,
16549,9,6,15,,,,
8653,23,41,64,,,,
14293,3,3,6,,,,
12467,33,1,34,,,,
2721,64,158,222,,,,
12526,1,13,14,,,,
5269,42,26,68,,,,
15242,14,19,33,,,,
17548,2,1,3,,,,
9317,11,7,18,,,,
6386,3,1,4,,,,
1420,26,139,165,,,,
9947,8,24,32,,,,
7694,64,63,127,,,,
10852,13,5,18,,,,
10038,7,9,16,,,,
4758,5,36,41,,,,
15636,6,12,18,,,,
14870,1,0,1,,,,
2651,41,5,46,,,,
8418,29,8,37,,,,
1801,255,31,286,,,,
14459,1,0,1,,,,
9364,6,1,7,,,,
12996,6,1,7,,,,
8288,7,2,9,,,,
15590,1,6,7,,,,
11100,2,2,4,,,,
14542,9,43,52,,,,
2988,24,0,24,,,,
9457,5,0,5,,,,
14544,1,46,47,,,,
1425,42,127,169,,,,
16309,1,24,25,,,,
4573,3,1,4,,,,
14131,18,9,27,,,,
2273,11,335,346,,,,
11205,4,30,34,,,,
15823,10,15,25,,,,
4988,16,41,57,,,,
5294,11,2,13,,,,
16052,3,18,21,,,,
8161,102,14,116,,,,
1421,86,123,209,,,,
11552,3,2,5,,,,
13559,11,14,25,,,,
11270,5,15,20,,,,
15848,2,0,2,,,,
40,11,14,25,,,,
13495,11,3,14,,,,
16466,5,4,9,,,,
2538,28,3,31,,,,
12473,18,8,26,,,,
787,13,27,40,,,,
8494,4,6,10,,,,
8859,11,0,11,,,,
697,176,51,227,,,,
7532,13,8,21,,,,
4170,25,6,31,,,,
14598,2,4,6,,,,
17287,6,12,18,,,,
9955,6,4,10,,,,
15883,8,0,8,,,,
4065,4,0,4,,,,
6430,8,15,23,,,,
9134,1,1,2,,,,
8473,2,28,30,,,,
11981,1,7,8,,,,
6230,47,32,79,,,,
6890,36,2,38,,,,
3036,52,9,61,,,,
4346,43,120,163,,,,
9432,6,1,7,,,,
1675,113,15,128,,,,
16210,6,9,15,,,,
2030,3,8,11,,,,
772,1,10,11,,,,
8509,17,19,36,,,,
4062,44,51,95,,,,
6065,20,3,23,,,,
14674,2,2,4,,,,
11005,7,20,27,,,,
1360,7,28,35,,,,
14375,6,1,7,,,,
4211,17,8,25,,,,
1243,1,20,21,,,,
7492,10,29,39,,,,
16756,2,1,3,,,,
11661,6,45,51,,,,
15988,9,17,26,,,,
8008,15,9,24,,,,
2494,2,1,3,,,,
2089,3,3,6,,,,
7312,3,11,14,,,,
9125,73,24,97,,,,
17567,1,12,13,,,,
8034,12,8,20,,,,
7892,11,10,21,,,,
2947,67,32,99,,,,
1728,42,181,223,,,,
17109,7,4,11,,,,
6457,9,0,9,,,,
8151,65,18,83,,,,
6980,2,4,6,,,,
13500,13,0,13,,,,
3922,45,9,54,,,,
2121,9,8,17,,,,
5977,6,11,17,,,,
10928,13,0,13,,,,
14378,17,3,20,,,,
10799,38,5,43,,,,
17053,1,25,26,,,,
7456,4,1,5,,,,
14532,4,5,9,,,,
14616,13,14,27,,,,
15379,9,8,17,,,,
14898,44,4,48,,,,
5026,12,11,23,,,,
3154,50,51,101,,,,
7001,5,1,6,,,,
2714,239,87,326,,,,
3048,31,4,35,,,,
1511,4,4,8,,,,
17141,21,2,23,,,,
15629,29,7,36,,,,
2549,73,0,73,,,,
13377,15,13,28,,,,
9118,13,0,13,,,,
1514,1,2,3,,,,
8851,2,10,12,,,,
981,11,11,22,,,,
553,9,94,103,,,,
11611,9,1,10,,,,
4184,1,1,2,,,,
5840,2,83,85,,,,
6033,8,3,11,,,,
14800,5,4,9,,,,
11489,30,29,59,,,,
7070,46,22,68,,,,
12507,3,3,6,,,,
614,12,175,187,,,,
6253,23,43,66,,,,
12559,1,4,5,,,,
5970,5,1,6,,,,
15528,6,1,7,,,,
3534,1,3,4,,,,
8360,7,0,7,,,,
12898,3,11,14,,,,
194,26,26,52,,,,
11810,85,8,93,,,,
2051,12,0,12,,,,
2626,27,87,114,,,,
10093,37,25,62,,,,
9620,2,4,6,,,,
9979,5,28,33,,,,
6128,2,9,11,,,,
17247,8,4,12,,,,
342,14,7,21,,,,
9068,14,12,26,,,,
14254,7,11,18,,,,
7615,9,1,10,,,,
16722,1,2,3,,,,
15605,7,30,37,,,,
2388,14,104,118,,,,
8667,2,0,2,,,,
4270,101,157,258,,,,
11252,7,15,22,,,,
144,23,5,28,,,,
7112,37,14,51,,,,
13769,4,8,12,,,,
10447,2,3,5,,,,
13677,6,21,27,,,,
4480,1,28,29,,,,
8157,48,75,123,,,,
7909,4,3,7,,,,
9975,12,13,25,,,,
17155,4,1,5,,,,
3175,54,92,146,,,,
3047,3,5,8,,,,
3300,28,129,157,,,,
4317,25,54,79,,,,
16056,4,20,24,,,,
150,32,72,104,,,,
11548,2,0,2,,,,
4019,11,18,29,,,,
5474,172,38,210,,,,
13358,9,2,11,,,,
10997,1,20,21,,,,
680,77,43,120,,,,
17807,1,0,1,,,,
14553,13,16,29,,,,
12531,44,13,57,,,,
9279,5,7,12,,,,
7446,12,22,34,,,,
15626,6,5,11,,,,
14489,3,12,15,,,,
16939,1,4,5,,,,
9880,8,7,15,,,,
9082,10,10,20,,,,
15692,27,3,30,,,,
1386,176,48,224,,,,
15506,6,0,6,,,,
16242,1,7,8,,,,
9791,10,1,11,,,,
12532,17,23,40,,,,
9969,1,6,7,,,,
6818,1,42,43,,,,
14485,1,4,5,,,,
2532,10,10,20,,,,
242,5,30,35,,,,
16058,20,31,51,,,,
235,49,30,79,,,,
7328,3,5,8,,,,
4635,4,33,37,,,,
9374,6,3,9,,,,
13383,10,21,31,,,,
10185,1,2,3,,,,
11771,20,8,28,,,,
104,24,14,38,,,,
11263,10,8,18,,,,
9632,34,41,75,,,,
5150,3,20,23,,,,
14788,13,2,15,,,,
14871,1,0,1,,,,
13776,32,0,32,,,,
12481,8,25,33,,,,
13886,3,19,22,,,,
5181,2,10,12,,,,
7881,1,1,2,,,,
9153,9,6,15,,,,
17554,1,2,3,,,,
15381,4,35,39,,,,
11282,1,1,2,,,,
3209,2,3,5,,,,
8063,2,2,4,,,,
5951,1,1,2,,,,
6522,4,10,14,,,,
3273,42,58,100,,,,
8374,1,1,2,,,,
4690,20,40,60,,,,
14615,2,15,17,,,,
3629,13,3,16,,,,
1769,27,32,59,,,,
14060,9,0,9,,,,
1780,58,14,72,,,,
7319,3,4,7,,,,
9654,2,0,2,,,,
12323,5,7,12,,,,
3723,32,33,65,,,,
12889,3,9,12,,,,
16307,19,0,19,,,,
6453,3,17,20,,,,
14048,9,30,39,,,,
12395,4,3,7,,,,
8818,5,0,5,,,,
12838,2,1,3,,,,
1160,3,3,6,,,,
14044,13,6,19,,,,
16595,2,12,14,,,,
15472,8,11,19,,,,
10329,2,2,4,,,,
7841,8,4,12,,,,
15821,4,11,15,,,,
7056,3,12,15,,,,
13458,2,4,6,,,,
15898,11,1,12,,,,
2865,8,67,75,,,,
13543,9,5,14,,,,
14818,23,21,44,,,,
2070,1,2,3,,,,
859,29,0,29,,,,
11560,27,12,39,,,,
13852,18,9,27,,,,
11026,4,12,16,,,,
1733,51,1,52,,,,
9230,5,4,9,,,,
1710,40,19,59,,,,
1488,29,5,34,,,,
15714,2,3,5,,,,
15899,3,10,13,,,,
8529,67,4,71,,,,
13142,2,0,2,,,,
11493,36,16,52,,,,
12701,8,3,11,,,,
2755,20,1,21,,,,
5019,4,6,10,,,,
2323,4,132,136,,,,
2456,26,23,49,,,,
5620,1,6,7,,,,
11989,4,5,9,,,,
7101,15,3,18,,,,
14068,37,32,69,,,,
8225,6,62,68,,,,
9138,4,4,8,,,,
5559,30,17,47,,,,
5098,9,3,12,,,,
17001,6,5,11,,,,
3232,144,24,168,,,,
17192,9,0,9,,,,
3431,1,7,8,,,,
16782,9,0,9,,,,
2667,4,41,45,,,,
15845,2,0,2,,,,
7493,42,24,66,,,,
2395,22,2,24,,,,
5185,28,4,32,,,,
3170,13,4,17,,,,
1624,61,40,101,,,,
15217,4,0,4,,,,
6605,6,0,6,,,,
16121,6,0,6,,,,
2263,21,2,23,,,,
15623,8,4,12,,,,
10094,43,0,43,,,,
16987,15,5,20,,,,
2290,37,34,71,,,,
5483,87,39,126,,,,
9996,11,12,23,,,,
107,124,35,159,,,,
12350,3,5,8,,,,
7140,3,15,18,,,,
11882,10,0,10,,,,
5099,8,31,39,,,,
4684,28,20,48,,,,
15663,2,0,2,,,,
14909,4,8,12,,,,
13534,10,6,16,,,,
6423,47,92,139,,,,
14534,1,7,8,,,,
7772,1,3,4,,,,
808,5,13,18,,,,
7153,6,2,8,,,,
2230,4,6,10,,,,
14739,3,0,3,,,,
16412,1,0,1,,,,
13040,4,3,7,,,,
5408,7,171,178,,,,
592,1,1,2,,,,
7208,2,5,7,,,,
6664,13,8,21,,,,
5992,5,4,9,,,,
5772,3,0,3,,,,
1062,1,3,4,,,,
17261,3,21,24,,,,
11089,5,11,16,,,,
3828,3,0,3,,,,
8502,5,1,6,,,,
728,4,137,141,,,,
7789,1,10,11,,,,
1712,45,25,70,,,,
5390,36,182,218,,,,
14358,6,8,14,,,,
17088,5,1,6,,,,
4119,7,28,35,,,,
10275,2,4,6,,,,
5229,31,51,82,,,,
10932,6,2,8,,,,
7888,8,63,71,,,,
5326,24,5,29,,,,
14143,7,12,19,,,,
17482,11,1,12,,,,
6512,20,0,20,,,,
4994,6,1,7,,,,
17806,2,2,4,,,,
555,14,75,89,,,,
7905,5,2,7,,,,
11660,9,7,16,,,,
14713,29,24,53,,,,
1340,58,19,77,,,,
4473,6,0,6,,,,
4404,13,0,13,,,,
16577,5,8,13,,,,
8640,7,15,22,,,,
11635,2,5,7,,,,
15363,7,12,19,,,,
3579,7,11,18,,,,
9764,1,0,1,,,,
13651,5,10,15,,,,
17208,6,1,7,,,,
6511,3,4,7,,,,
11965,2,18,20,,,,
8792,75,25,100,,,,
8986,24,41,65,,,,
4171,11,8,19,,,,
8936,6,30,36,,,,
5839,5,4,9,,,,
3612,7,9,16,,,,
6160,1,7,8,,,,
10125,7,1,8,,,,
12497,18,33,51,,,,
11090,1,4,5,,,,
4102,7,6,13,,,,
14395,10,10,20,,,,
13927,11,68,79,,,,
7064,9,7,16,,,,
5712,18,0,18,,,,
16875,6,3,9,,,,
14154,48,17,65,,,,
10226,32,0,32,,,,
17104,1,26,27,,,,
11556,36,4,40,,,,
9907,12,4,16,,,,
6048,79,10,89,,,,
6971,39,5,44,,,,
6681,82,35,117,,,,
17086,1,3,4,,,,
5874,10,3,13,,,,
558,277,105,382,,,,
11797,11,37,48,,,,
768,48,176,224,,,,
11900,2,4,6,,,,
5,11,29,40,,,,
9701,12,20,32,,,,
10905,4,0,4,,,,
12969,6,5,11,,,,
1875,5,53,58,,,,
14193,34,59,93,,,,
15110,17,0,17,,,,
7461,2,3,5,,,,
11684,34,11,45,,,,
13152,8,11,19,,,,
2576,38,2,40,,,,
10402,4,14,18,,,,
9440,1,5,6,,,,
12078,8,12,20,,,,
17133,8,11,19,,,,
3883,24,35,59,,,,
8853,4,6,10,,,,
13782,1,2,3,,,,
2446,35,68,103,,,,
17765,3,1,4,,,,
1652,8,12,20,,,,
14197,17,15,32,,,,
9860,63,105,168,,,,
5493,23,50,73,,,,
1603,310,36,346,,,,
16049,34,4,38,,,,
5362,46,173,219,,,,
6145,6,11,17,,,,
11732,56,16,72,,,,
3540,10,1,11,,,,
17089,11,5,16,,,,
101,11,49,60,,,,
10075,3,12,15,,,,
1336,4,199,203,,,,
12615,11,9,20,,,,
3342,8,77,85,,,,
2406,140,41,181,,,,
13768,7,5,12,,,,
5337,3,8,11,,,,
11393,6,15,21,,,,
5678,4,6,10,,,,
3349,80,24,104,,,,
9554,9,69,78,,,,
2416,45,78,123,,,,
11433,27,5,32,,,,
156,326,8,334,,,,
16538,2,1,3,,,,
14551,2,28,30,,,,
8749,10,22,32,,,,
5705,3,8,11,,,,
13697,1,1,2,,,,
10432,12,14,26,,,,
11998,9,14,23,,,,
15229,4,8,12,,,,
15228,7,0,7,,,,
10043,23,1,24,,,,
14730,32,8,40,,,,
2404,104,94,198,,,,
14687,22,12,34,,,,
10082,4,4,8,,,,
7145,3,8,11,,,,
17462,2,1,3,,,,
12282,1,8,9,,,,
5835,56,4,60,,,,
7523,2,8,10,,,,
5091,10,9,19,,,,
1293,13,200,213,,,,
4738,1,23,24,,,,
4025,11,47,58,,,,
9281,30,5,35,,,,
6567,9,5,14,,,,
17348,3,0,3,,,,
117,124,216,340,,,,
7142,2,16,18,,,,
11666,2,44,46,,,,
7619,16,22,38,,,,
721,13,123,136,,,,
16169,9,1,10,,,,
1073,7,1,8,,,,
13514,27,4,31,,,,
13485,15,19,34,,,,
10109,3,10,13,,,,
1045,11,6,17,,,,
9719,25,2,27,,,,
15282,20,31,51,,,,
11737,10,13,23,,,,
17025,10,1,11,,,,
13792,1,5,6,,,,
4929,8,41,49,,,,
9240,2,17,19,,,,
11054,4,2,6,,,,
15164,1,4,5,,,,
4934,65,30,95,,,,
257,3,1,4,,,,
6744,19,9,28,,,,
14300,9,9,18,,,,
3752,8,8,16,,,,
4979,2,5,7,,,,
8192,39,1,40,,,,
16452,7,7,14,,,,
17343,4,8,12,,,,
8987,43,65,108,,,,
11701,15,59,74,,,,
3156,1,3,4,,,,
357,3,40,43,,,,
10937,4,0,4,,,,
12762,1,1,2,,,,
12125,23,1,24,,,,
647,10,12,22,,,,
986,79,30,109,,,,
1389,140,37,177,,,,
5143,11,1,12,,,,
16809,6,5,11,,,,
14805,4,16,20,,,,
11527,1,8,9,,,,
13765,4,7,11,,,,
8634,3,3,6,,,,
7271,21,9,30,,,,
2814,7,2,9,,,,
3996,17,10,27,,,,
4051,3,2,5,,,,
5819,46,37,83,,,,
5564,13,6,19,,,,
103,147,25,172,,,,
9573,17,9,26,,,,
15750,1,3,4,,,,
12460,31,66,97,,,,
17795,1,4,5,,,,
12090,18,0,18,,,,
2677,58,52,110,,,,
6496,18,2,20,,,,
3740,19,1,20,,,,
14757,11,1,12,,,,
8364,2,2,4,,,,
5047,1,39,40,,,,
3229,10,4,14,,,,
4590,19,15,34,,,,
3852,15,7,22,,,,
14200,6,22,28,,,,
1227,6,115,121,,,,
2522,64,32,96,,,,
2308,64,35,99,,,,
1205,5,3,8,,,,
5361,68,110,178,,,,
5503,97,100,197,,,,
893,1,1,2,,,,
11789,150,19,169,,,,
12937,3,6,9,,,,
1332,55,17,72,,,,
4137,32,12,44,,,,
2058,3,5,8,,,,
4688,34,37,71,,,,
7435,1,4,5,,,,
9729,89,5,94,,,,
9513,10,2,12,,,,
3510,17,16,33,,,,
1597,14,148,162,,,,
8867,10,0,10,,,,
9141,12,3,15,,,,
17323,8,2,10,,,,
4997,5,72,77,,,,
9285,8,0,8,,,,
13614,3,31,34,,,,
3353,42,8,50,,,,
2757,15,14,29,,,,
8562,27,2,29,,,,
11338,87,18,105,,,,
16559,3,0,3,,,,
8097,1,4,5,,,,
6055,101,14,115,,,,
5495,18,0,18,,,,
16512,3,3,6,,,,
2291,3,8,11,,,,
7491,28,3,31,,,,
15351,3,3,6,,,,
2045,11,3,14,,,,
4112,2,31,33,,,,
16826,5,2,7,,,,
17195,5,1,6,,,,
14644,11,7,18,,,,
49,2,4,6,,,,
10891,5,4,9,,,,
7197,3,0,3,,,,
15090,7,5,12,,,,
7569,12,17,29,,,,
16804,8,10,18,,,,
1829,18,27,45,,,,
1858,45,33,78,,,,
5190,6,13,19,,,,
14578,6,10,16,,,,
6330,30,4,34,,,,
2625,14,3,17,,,,
9610,2,11,13,,,,
2661,57,25,82,,,,
5009,62,12,74,,,,
3005,22,7,29,,,,
9122,10,0,10,,,,
9511,9,7,16,,,,
7847,22,19,41,,,,
10159,8,1,9,,,,
10692,4,1,5,,,,
7481,7,11,18,,,,
1432,1,95,96,,,,
15346,3,0,3,,,,
6768,10,10,20,,,,
4066,19,10,29,,,,
10192,5,69,74,,,,
4497,2,21,23,,,,
11721,21,2,23,,,,
2967,28,5,33,,,,
2363,3,42,45,,,,
2767,26,3,29,,,,
6991,16,12,28,,,,
4222,23,11,34,,,,
4705,4,31,35,,,,
4477,8,37,45,,,,
4408,19,41,60,,,,
13060,4,3,7,,,,
14464,4,0,4,,,,
17035,42,21,63,,,,
16243,4,3,7,,,,
6050,1,83,84,,,,
13460,1,11,12,,,,
1786,82,26,108,,,,
6426,11,12,23,,,,
813,15,2,17,,,,
3541,64,29,93,,,,
7015,4,0,4,,,,
7799,10,9,19,,,,
7048,4,5,9,,,,
7938,4,19,23,,,,
15330,3,0,3,,,,
7272,2,16,18,,,,
5780,11,8,19,,,,
11652,1,28,29,,,,
9544,6,13,19,,,,
10512,36,10,46,,,,
13977,2,0,2,,,,
10970,8,1,9,,,,
9624,9,14,23,,,,
14036,7,10,17,,,,
5912,4,7,11,,,,
13907,3,10,13,,,,
3221,5,11,16,,,,
13032,9,2,11,,,,
5496,57,126,183,,,,
6700,15,125,140,,,,
16274,8,12,20,,,,
11237,1,2,3,,,,
4014,4,6,10,,,,
8826,3,5,8,,,,
783,6,9,15,,,,
6001,5,2,7,,,,
16050,54,1,55,,,,
10333,2,2,4,,,,
5146,22,0,22,,,,
1908,77,9,86,,,,
15083,24,18,42,,,,
17447,1,0,1,,,,
17069,1,4,5,,,,
12600,1,1,2,,,,
6152,4,2,6,,,,
1093,11,39,50,,,,
15847,15,12,27,,,,
9641,1,7,8,,,,
8395,36,13,49,,,,
1744,56,133,189,,,,
9373,16,31,47,,,,
8020,30,5,35,,,,
10465,32,12,44,,,,
9848,49,1,50,,,,
14694,32,27,59,,,,
4120,13,12,25,,,,
16089,8,35,43,,,,
15138,2,6,8,,,,
11643,4,35,39,,,,
13314,1,9,10,,,,
4654,18,9,27,,,,
9498,1,9,10,,,,
5554,9,0,9,,,,
5139,4,10,14,,,,
16304,14,0,14,,,,
2543,5,1,6,,,,
14608,5,18,23,,,,
15124,4,12,16,,,,
7515,4,13,17,,,,
11174,37,36,73,,,,
8413,5,3,8,,,,
1266,20,31,51,,,,
16671,4,1,5,,,,
667,58,2,60,,,,
17598,1,1,2,,,,
9063,19,0,19,,,,
8201,54,19,73,,,,
3448,10,50,60,,,,
9,3,22,25,,,,
5074,10,8,18,,,,
10695,1,118,119,,,,
775,23,14,37,,,,
3067,19,234,253,,,,
10441,3,4,7,,,,
1439,26,9,35,,,,
16764,2,2,4,,,,
16966,4,1,5,,,,
12448,25,30,55,,,,
5544,3,16,19,,,,
2610,43,86,129,,,,
6838,9,5,14,,,,
10256,2,4,6,,,,
6013,1,1,2,,,,
7154,27,5,32,,,,
10731,5,31,36,,,,
2484,29,3,32,,,,
7833,10,7,17,,,,
2639,23,9,32,,,,
4639,14,15,29,,,,
15050,18,13,31,,,,
70,90,100,190,,,,
398,2,1,3,,,,
2430,14,15,29,,,,
17687,1,3,4,,,,
12059,16,2,18,,,,
16903,10,8,18,,,,
9694,2,8,10,,,,
7193,41,272,313,,,,
10578,6,0,6,,,,
3407,41,31,72,,,,
7235,15,3,18,,,,
13159,1,20,21,,,,
10108,1,0,1,,,,
6133,14,5,19,,,,
8885,4,5,9,,,,
13653,1,0,1,,,,
1599,58,125,183,,,,
2917,16,31,47,,,,
6470,3,47,50,,,,
9813,1,4,5,,,,
10147,2,10,12,,,,
5068,29,3,32,,,,
16186,16,14,30,,,,
17471,13,13,26,,,,
60,146,61,207,,,,
11752,14,12,26,,,,
12995,1,2,3,,,,
14308,19,0,19,,,,
2096,3,1,4,,,,
13442,18,5,23,,,,
13517,16,2,18,,,,
9236,1,0,1,,,,
15411,4,24,28,,,,
5280,17,19,36,,,,
11154,9,6,15,,,,
15891,4,1,5,,,,
3359,12,21,33,,,,
6406,25,22,47,,,,
10564,8,68,76,,,,
14862,1,5,6,,,,
9272,21,0,21,,,,
17047,29,4,33,,,,
12359,64,36,100,,,,
4316,16,111,127,,,,
6540,7,6,13,,,,
15324,1,1,2,,,,
13198,10,23,33,,,,
962,1,17,18,,,,
13118,14,2,16,,,,
8862,28,10,38,,,,
6804,16,2,18,,,,
5274,2,10,12,,,,
12370,7,4,11,,,,
16795,3,6,9,,,,
15993,2,0,2,,,,
15237,6,0,6,,,,
12730,3,8,11,,,,
9217,7,17,24,,,,
162,28,756,784,,,,
2953,38,66,104,,,,
68,86,37,123,,,,
8162,128,16,144,,,,
198,1,4,5,,,,
2253,6,4,10,,,,
13086,6,7,13,,,,
14872,8,2,10,,,,
5727,30,3,33,,,,
12779,9,0,9,,,,
12160,3,12,15,,,,
2977,27,11,38,,,,
2882,32,110,142,,,,
4046,2,3,5,,,,
6928,22,9,31,,,,
15752,8,4,12,,,,
12580,22,8,30,,,,
33,8,5,13,,,,
15220,1,8,9,,,,
1406,133,13,146,,,,
16289,3,3,6,,,,
14319,2,10,12,,,,
13549,17,2,19,,,,
9036,5,5,10,,,,
4966,2,1,3,,,,
17034,5,6,11,,,,
4667,30,0,30,,,,
4714,76,3,79,,,,
3278,53,8,61,,,,
1428,35,21,56,,,,
627,23,11,34,,,,
15673,3,4,7,,,,
5731,10,14,24,,,,
2433,23,38,61,,,,
2817,3,0,3,,,,
9765,9,2,11,,,,
1362,64,43,107,,,,
16063,16,18,34,,,,
9617,36,22,58,,,,
8052,24,2,26,,,,
13112,12,1,13,,,,
4579,4,8,12,,,,
17435,2,6,8,,,,
8330,17,2,19,,,,
11573,4,15,19,,,,
9567,26,11,37,,,,
15238,7,8,15,,,,
3919,42,25,67,,,,
224,8,4,12,,,,
3932,2,4,6,,,,
3400,4,3,7,,,,
5629,10,75,85,,,,
7910,18,20,38,,,,
14840,13,24,37,,,,
11286,1,1,2,,,,
1947,22,71,93,,,,
6047,52,6,58,,,,
3777,3,2,5,,,,
2320,11,78,89,,,,
4606,84,5,89,,,,
5818,32,9,41,,,,
882,14,31,45,,,,
14260,22,3,25,,,,
13962,3,0,3,,,,
17366,6,2,8,,,,
3159,47,9,56,,,,
17734,1,0,1,,,,
263,7,16,23,,,,
10351,6,2,8,,,,
16271,15,5,20,,,,
8664,7,7,14,,,,
13055,20,9,29,,,,
12887,3,1,4,,,,
10486,13,16,29,,,,
2842,84,0,84,,,,
5255,24,1,25,,,,
13753,1,2,3,,,,
12198,19,18,37,,,,
11500,16,25,41,,,,
333,24,5,29,,,,
1495,50,46,96,,,,
4168,4,2,6,,,,
15973,10,5,15,,,,
4486,5,9,14,,,,
5189,2,5,7,,,,
10396,25,25,50,,,,
16399,4,7,11,,,,
5210,26,1,27,,,,
13369,2,0,2,,,,
12479,13,14,27,,,,
6277,22,23,45,,,,
13265,6,1,7,,,,
11816,3,4,7,,,,
8832,5,0,5,,,,
16802,4,1,5,,,,
5836,3,7,10,,,,
14935,3,0,3,,,,
11184,22,35,57,,,,
5873,4,10,14,,,,
2855,34,39,73,,,,
1700,17,8,25,,,,
12743,2,1,3,,,,
17585,10,0,10,,,,
13956,5,9,14,,,,
13562,6,8,14,,,,
546,214,106,320,,,,
3054,36,2,38,,,,
878,10,4,14,,,,
339,8,2,10,,,,
16845,17,0,17,,,,
16357,4,3,7,,,,
12229,6,12,18,,,,
9335,2,2,4,,,,
3421,6,9,15,,,,
17190,2,12,14,,,,
12657,17,7,24,,,,
1066,68,42,110,,,,
14526,1,6,7,,,,
9768,8,4,12,,,,
745,143,0,143,,,,
6166,15,5,20,,,,
10687,5,0,5,,,,
6580,3,1,4,,,,
13640,2,2,4,,,,
10156,11,6,17,,,,
15107,8,9,17,,,,
1548,36,95,131,,,,
15968,2,2,4,,,,
4151,12,6,18,,,,
8259,19,8,27,,,,
13208,3,84,87,,,,
17021,1,2,3,,,,
2023,4,1,5,,,,
7992,16,34,50,,,,
14589,2,3,5,,,,
1889,26,13,39,,,,
14563,30,32,62,,,,
12039,2,1,3,,,,
11419,12,0,12,,,,
15715,1,13,14,,,,
1513,7,4,11,,,,
2556,20,17,37,,,,
4887,9,10,19,,,,
127,56,434,490,,,,
10445,2,3,5,,,,
2931,52,97,149,,,,
17119,7,3,10,,,,
1510,7,3,10,,,,
11554,14,1,15,,,,
15168,3,2,5,,,,
8036,8,35,43,,,,
9462,3,2,5,,,,
15516,1,3,4,,,,
7094,24,9,33,,,,
5981,6,1,7,,,,
16724,4,7,11,,,,
16884,15,0,15,,,,
14082,4,8,12,,,,
1816,7,43,50,,,,
11049,3,7,10,,,,
15722,2,4,6,,,,
13626,7,6,13,,,,
16698,2,15,17,,,,
1688,6,432,438,,,,
11488,60,16,76,,,,
11304,3,6,9,,,,
1492,6,17,23,,,,
11451,8,10,18,,,,
5196,11,2,13,,,,
1484,23,0,23,,,,
15210,6,1,7,,,,
12408,2,3,5,,,,
14130,4,15,19,,,,
15313,15,2,17,,,,
9982,4,79,83,,,,
7478,14,2,16,,,,
14431,24,6,30,,,,
15044,9,10,19,,,,
12183,11,1,12,,,,
1320,26,16,42,,,,
15020,13,9,22,,,,
14224,25,7,32,,,,
17233,3,2,5,,,,
4358,94,3,97,,,,
16206,4,13,17,,,,
16107,8,12,20,,,,
12921,5,5,10,,,,
16964,3,13,16,,,,
11953,84,12,96,,,,
4011,15,73,88,,,,
4210,38,5,43,,,,
15154,7,2,9,,,,
12572,14,19,33,,,,
14691,12,35,47,,,,
1081,30,3,33,,,,
8317,38,10,48,,,,
8470,8,0,8,,,,
7605,8,28,36,,,,
15901,6,0,6,,,,
8244,1,17,18,,,,
16892,4,3,7,,,,
5567,27,19,46,,,,
4110,4,26,30,,,,
10726,6,0,6,,,,
15661,12,10,22,,,,
7591,14,18,32,,,,
6324,41,53,94,,,,
4297,15,1,16,,,,
715,36,98,134,,,,
9329,22,42,64,,,,
14517,1,9,10,,,,
2582,22,16,38,,,,
3157,6,2,8,,,,
1825,17,23,40,,,,
3033,7,3,10,,,,
1032,5,7,12,,,,
9145,7,2,9,,,,
6646,49,36,85,,,,
10019,4,19,23,,,,
2724,169,91,260,,,,
484,89,71,160,,,,
1989,10,46,56,,,,
7576,41,2,43,,,,
8835,3,0,3,,,,
8449,7,5,12,,,,
6966,2,0,2,,,,
1317,3,24,27,,,,
3271,11,6,17,,,,
10855,20,1,21,,,,
17164,1,7,8,,,,
148,114,111,225,,,,
7469,4,5,9,,,,
10536,36,26,62,,,,
7323,37,146,183,,,,
17787,10,5,15,,,,
7333,11,4,15,,,,
15815,4,4,8,,,,
7775,10,1,11,,,,
1881,64,78,142,,,,
13597,2,10,12,,,,
7807,15,13,28,,,,
13727,6,3,9,,,,
9018,4,2,6,,,,
3924,10,0,10,,,,
109,16,77,93,,,,
8068,1,8,9,,,,
6197,16,15,31,,,,
6624,22,11,33,,,,
755,55,21,76,,,,
13491,15,8,23,,,,
10172,2,1,3,,,,
4482,26,13,39,,,,
7747,1,6,7,,,,
10837,1,0,1,,,,
10131,1,1,2,,,,
4136,24,10,34,,,,
7889,14,2,16,,,,
3655,26,98,124,,,,
4466,9,9,18,,,,
1234,5,0,5,,,,
8731,24,26,50,,,,
10140,3,2,5,,,,
16219,3,5,8,,,,
10218,15,22,37,,,,
8325,3,19,22,,,,
5138,1,4,5,,,,
7313,7,11,18,,,,
10506,47,23,70,,,,
12581,3,6,9,,,,
7811,20,6,26,,,,
8379,7,34,41,,,,
2274,43,133,176,,,,
9316,8,24,32,,,,
8840,66,35,101,,,,
9197,2,2,4,,,,
12264,1,0,1,,,,
5988,6,7,13,,,,
9576,21,6,27,,,,
14179,2,50,52,,,,
13577,2,11,13,,,,
16111,29,24,53,,,,
16757,6,2,8,,,,
13522,9,6,15,,,,
2910,17,24,41,,,,
7541,35,0,35,,,,
2042,6,0,6,,,,
4082,1,0,1,,,,
13364,2,1,3,,,,
16473,8,2,10,,,,
7791,2,7,9,,,,
3893,7,22,29,,,,
1823,14,21,35,,,,
10166,1,4,5,,,,
17402,2,0,2,,,,
11380,7,14,21,,,,
5799,4,2,6,,,,
5319,9,6,15,,,,
3108,3,2,5,,,,
12013,70,24,94,,,,
10644,6,7,13,,,,
11467,9,23,32,,,,
489,1,7,8,,,,
9755,12,6,18,,,,
12632,5,1,6,,,,
8533,11,24,35,,,,
14354,6,41,47,,,,
8160,54,49,103,,,,
12652,14,6,20,,,,
14361,4,30,34,,,,
14701,13,8,21,,,,
12421,42,16,58,,,,
3912,57,15,72,,,,
13261,2,8,10,,,,
11915,17,15,32,,,,
7191,59,177,236,,,,
17680,8,5,13,,,,
2963,2,33,35,,,,
6444,8,7,15,,,,
10624,25,2,27,,,,
3837,2,0,2,,,,
2285,18,3,21,,,,
6479,45,7,52,,,,
17767,3,28,31,,,,
6432,36,34,70,,,,
9110,5,1,6,,,,
3840,5,5,10,,,,
1683,22,21,43,,,,
14411,5,0,5,,,,
8168,70,35,105,,,,
1771,10,37,47,,,,
11515,14,16,30,,,,
490,18,39,57,,,,
10349,2,20,22,,,,
6395,4,19,23,,,,
26,8,2,10,,,,
11768,26,3,29,,,,
15819,1,0,1,,,,
13148,22,0,22,,,,
1669,48,31,79,,,,
8703,1,6,7,,,,
17268,12,3,15,,,,
7667,21,17,38,,,,
9902,1,10,11,,,,
6666,3,8,11,,,,
2466,7,14,21,,,,
12900,12,1,13,,,,
13912,3,9,12,,,,
13540,5,6,11,,,,
741,8,22,30,,,,
12410,4,12,16,,,,
17130,7,1,8,,,,
7403,21,1,22,,,,
3806,9,19,28,,,,
1478,55,19,74,,,,
3908,3,4,7,,,,
10795,7,7,14,,,,
13505,5,8,13,,,,
3023,37,10,47,,,,
971,5,7,12,,,,
6491,17,7,24,,,,
10934,1,3,4,,,,
13293,5,2,7,,,,
10162,14,7,21,,,,
16053,8,13,21,,,,
16415,25,0,25,,,,
16516,1,4,5,,,,
16545,1,2,3,,,,
7364,1,0,1,,,,
4383,7,3,10,,,,
11388,8,0,8,,,,
16306,5,12,17,,,,
13520,14,3,17,,,,
13532,26,0,26,,,,
7019,2,2,4,,,,
13022,2,9,11,,,,
2583,21,19,40,,,,
4096,23,10,33,,,,
13361,6,0,6,,,,
17018,4,2,6,,,,
7587,7,1,8,,,,
12708,6,9,15,,,,
3940,55,7,62,,,,
14924,11,7,18,,,,
3383,7,8,15,,,,
11182,11,5,16,,,,
12717,9,3,12,,,,
1411,95,117,212,,,,
15834,1,1,2,,,,
1515,5,0,5,,,,
1549,44,61,105,,,,
4575,11,10,21,,,,
9611,9,12,21,,,,
17480,1,12,13,,,,
12129,2,5,7,,,,
1475,8,3,11,,,,
6132,1,2,3,,,,
15952,7,0,7,,,,
16749,3,9,12,,,,
1903,2,12,14,,,,
17915,1,0,1,,,,
11064,1,5,6,,,,
8283,42,32,74,,,,
5795,4,0,4,,,,
179,484,61,545,,,,
5556,10,43,53,,,,
13729,33,33,66,,,,
1226,2,1,3,,,,
6833,21,16,37,,,,
16842,8,3,11,,,,
11088,6,92,98,,,,
13688,5,0,5,,,,
9360,9,0,9,,,,
4791,10,28,38,,,,
16531,2,11,13,,,,
3012,12,28,40,,,,
3440,8,1,9,,,,
6905,1,41,42,,,,
1940,25,35,60,,,,
6182,3,75,78,,,,
4418,25,26,51,,,,
14315,17,8,25,,,,
14822,38,13,51,,,,
2617,15,154,169,,,,
2679,1,8,9,,,,
2791,20,16,36,,,,
15759,2,7,9,,,,
12627,3,3,6,,,,
6476,2,1,3,,,,
11641,6,15,21,,,,
1973,8,3,11,,,,
440,8,4,12,,,,
6503,10,10,20,,,,
8673,5,2,7,,,,
15004,16,2,18,,,,
16116,1,0,1,,,,
15947,6,0,6,,,,
9956,12,1,13,,,,
9613,12,7,19,,,,
16043,33,13,46,,,,
14047,7,6,13,,,,
83,70,10,80,,,,
16020,33,19,52,,,,
11595,4,6,10,,,,
8739,89,4,93,,,,
6282,36,16,52,,,,
16373,10,9,19,,,,
7712,1,3,4,,,,
1101,2,2,4,,,,
9278,3,15,18,,,,
11884,8,9,17,,,,
11009,5,4,9,,,,
5092,10,2,12,,,,
4983,14,12,26,,,,
4519,3,3,6,,,,
11395,5,3,8,,,,
6442,13,23,36,,,,
7370,31,14,45,,,,
3374,28,55,83,,,,
7566,2,31,33,,,,
4783,6,17,23,,,,
6083,2,1,3,,,,
5140,1,30,31,,,,
9025,5,6,11,,,,
4369,1,6,7,,,,
14932,6,7,13,,,,
5755,3,2,5,,,,
8557,21,35,56,,,,
16442,13,7,20,,,,
10112,1,10,11,,,,
6036,32,5,37,,,,
9175,14,1,15,,,,
5633,44,18,62,,,,
7034,1,7,8,,,,
6373,3,4,7,,,,
7607,1,0,1,,,,
2154,31,6,37,,,,
11930,13,21,34,,,,
12444,2,9,11,,,,
8234,87,55,142,,,,
8544,33,26,59,,,,
9126,8,0,8,,,,
10748,3,16,19,,,,
4548,26,3,29,,,,
14318,4,0,4,,,,
5785,3,3,6,,,,
16303,7,3,10,,,,
10989,3,1,4,,,,
11346,20,52,72,,,,
413,3,2,5,,,,
5551,53,24,77,,,,
4963,9,19,28,,,,
15927,2,4,6,,,,
3747,6,12,18,,,,
17762,7,2,9,,,,
10540,30,5,35,,,,
3103,3,4,7,,,,
8000,9,0,9,,,,
3900,2,1,3,,,,
12046,12,1,13,,,,
14284,49,5,54,,,,
12536,1,21,22,,,,
3887,21,0,21,,,,
4709,34,45,79,,,,
13146,5,2,7,,,,
4200,1,12,13,,,,
11757,24,24,48,,,,
3716,5,25,30,,,,
5168,5,7,12,,,,
11535,2,2,4,,,,
9584,3,1,4,,,,
2880,5,8,13,,,,
16774,5,12,17,,,,
14424,3,11,14,,,,
3210,2,4,6,,,,
2936,11,3,14,,,,
1560,54,22,76,,,,
3873,9,0,9,,,,
6181,67,2,69,,,,
16456,7,2,9,,,,
14023,5,0,5,,,,
11053,1,9,10,,,,
665,52,27,79,,,,
12726,1,2,3,,,,
15729,4,8,12,,,,
6820,9,16,25,,,,
14974,3,12,15,,,,
7318,5,5,10,,,,
13080,5,0,5,,,,
3485,22,19,41,,,,
4235,18,2,20,,,,
4095,17,34,51,,,,
15354,4,0,4,,,,
2252,6,11,17,,,,
12136,3,1,4,,,,
4808,30,17,47,,,,
8638,1,7,8,,,,
14965,8,0,8,,,,
17101,2,3,5,,,,
6850,25,18,43,,,,
10903,2,9,11,,,,
6703,20,58,78,,,,
6142,4,15,19,,,,
898,12,0,12,,,,
12290,10,42,52,,,,
9566,7,4,11,,,,
9076,12,32,44,,,,
8834,9,10,19,,,,
16776,2,7,9,,,,
15755,3,1,4,,,,
1377,56,11,67,,,,
17536,3,1,4,,,,
2008,2,1,3,,,,
11681,12,25,37,,,,
6787,2,13,15,,,,
2319,37,15,52,,,,
9919,5,4,9,,,,
12071,9,2,11,,,,
7808,29,10,39,,,,
1138,2,73,75,,,,
1501,6,8,14,,,,
13349,1,1,2,,,,
684,73,30,103,,,,
17543,4,0,4,,,,
770,17,7,24,,,,
9339,12,20,32,,,,
9532,1,10,11,,,,
13797,3,11,14,,,,
6454,3,23,26,,,,
9680,5,1,6,,,,
6382,3,0,3,,,,
7549,22,7,29,,,,
12165,4,14,18,,,,
75,5,44,49,,,,
15432,6,0,6,,,,
1715,47,132,179,,,,
16734,4,0,4,,,,
10224,3,3,6,,,,
6775,17,27,44,,,,
1137,7,2,9,,,,
17817,2,1,3,,,,
6712,1,1,2,,,,
549,3,16,19,,,,
1413,55,136,191,,,,
12361,10,16,26,,,,
15299,19,9,28,,,,
10967,1,0,1,,,,
15121,1,0,1,,,,
6840,3,1,4,,,,
3773,3,13,16,,,,
16850,6,1,7,,,,
4517,6,44,50,,,,
6946,2,8,10,,,,
14169,25,2,27,,,,
6379,6,0,6,,,,
13170,51,20,71,,,,
4666,29,19,48,,,,
3717,26,65,91,,,,
5792,11,9,20,,,,
1639,34,85,119,,,,
7986,17,29,46,,,,
10374,3,3,6,,,,
16555,15,10,25,,,,
1318,5,38,43,,,,
1289,17,57,74,,,,
15269,7,0,7,,,,
2690,21,3,24,,,,
1620,7,24,31,,,,
10907,1,2,3,,,,
9879,20,11,31,,,,
9162,39,6,45,,,,
3616,1,0,1,,,,
766,12,7,19,,,,
8765,3,5,8,,,,
7457,2,9,11,,,,
10796,15,7,22,,,,
12518,9,3,12,,,,
16959,2,1,3,,,,
17056,5,19,24,,,,
13516,1,2,3,,,,
14174,52,19,71,,,,
15948,2,2,4,,,,
7994,69,0,69,,,,
7173,7,9,16,,,,
5053,17,8,25,,,,
9853,23,169,192,,,,
8574,13,41,54,,,,
15252,1,3,4,,,,
17871,3,12,15,,,,
15718,6,1,7,,,,
2948,92,12,104,,,,
4646,2,2,4,,,,
5944,1,21,22,,,,
15424,11,9,20,,,,
629,4,11,15,,,,
7745,9,1,10,,,,
13789,2,12,14,,,,
13373,2,4,6,,,,
7147,39,4,43,,,,
9751,8,8,16,,,,
2770,13,26,39,,,,
17095,5,0,5,,,,
177,392,58,450,,,,
14712,38,0,38,,,,
1797,20,139,159,,,,
15342,1,5,6,,,,
12776,4,4,8,,,,
6228,43,49,92,,,,
4910,2,3,5,,,,
3465,51,12,63,,,,
7434,3,0,3,,,,
9188,7,14,21,,,,
9005,25,25,50,,,,
189,10,20,30,,,,
16211,7,11,18,,,,
3280,56,4,60,,,,
8175,13,43,56,,,,
13895,4,2,6,,,,
5005,40,8,48,,,,
14037,1,3,4,,,,
11443,8,2,10,,,,
11864,4,8,12,,,,
12366,7,1,8,,,,
7564,10,35,45,,,,
11623,6,5,11,,,,
2547,4,20,24,,,,
819,24,4,28,,,,
8604,9,5,14,,,,
3847,1,2,3,,,,
11233,26,1,27,,,,
2157,1,3,4,,,,
3305,1,17,18,,,,
8328,22,22,44,,,,
2282,6,4,10,,,,
3434,2,20,22,,,,
11085,5,3,8,,,,
8905,1,2,3,,,,
13166,37,12,49,,,,
2786,11,0,11,,,,
15270,2,11,13,,,,
6154,6,10,16,,,,
16130,4,2,6,,,,
5137,17,13,30,,,,
11041,25,20,45,,,,
16261,3,10,13,,,,
2854,37,32,69,,,,
16824,8,2,10,,,,
1793,3,45,48,,,,
18,33,1,34,,,,
11501,3,11,14,,,,
9388,44,2,46,,,,
12501,13,11,24,,,,
15725,2,6,8,,,,
259,6,15,21,,,,
1631,52,163,215,,,,
11323,86,96,182,,,,
5911,7,2,9,,,,
6918,20,12,32,,,,
17811,5,4,9,,,,
11733,20,22,42,,,,
13332,1,2,3,,,,
4990,2,1,3,,,,
7299,1,9,10,,,,
879,30,35,65,,,,
11917,5,5,10,,,,
3218,1,1,2,,,,
2437,115,39,154,,,,
10045,1,12,13,,,,
12772,6,11,17,,,,
14021,9,19,28,,,,
12244,1,0,1,,,,
16477,16,0,16,,,,
11942,11,4,15,,,,
12629,4,3,7,,,,
9302,6,0,6,,,,
14015,12,6,18,,,,
14290,20,6,26,,,,
1229,1,0,1,,,,
1020,4,3,7,,,,
8589,12,0,12,,,,
2174,1,23,24,,,,
16095,27,7,34,,,,
1830,140,92,232,,,,
3197,7,1,8,,,,
5587,2,0,2,,,,
6129,7,2,9,,,,
7595,4,0,4,,,,
6374,10,0,10,,,,
1645,8,342,350,,,,
7039,4,4,8,,,,
15459,4,11,15,,,,
16139,4,4,8,,,,
10568,25,6,31,,,,
7820,99,15,114,,,,
12656,13,17,30,,,,
7525,76,49,125,,,,
5030,20,24,44,,,,
11553,3,21,24,,,,
8870,1,11,12,,,,
14847,24,18,42,,,,
7487,3,9,12,,,,
6549,2,18,20,,,,
7339,2,4,6,,,,
14043,6,9,15,,,,
4576,9,8,17,,,,
7176,1,6,7,,,,
5746,38,19,57,,,,
12640,7,7,14,,,,
14322,2,4,6,,,,
1767,102,45,147,,,,
12605,16,7,23,,,,
14706,13,2,15,,,,
4940,5,10,15,,,,
1119,8,10,18,,,,
5477,5,84,89,,,,
8166,104,44,148,,,,
10365,12,0,12,,,,
7297,2,7,9,,,,
8677,5,8,13,,,,
13412,22,0,22,,,,
17874,4,2,6,,,,
2560,5,0,5,,,,
3724,11,12,23,,,,
15205,5,3,8,,,,
8913,2,5,7,,,,
12636,1,3,4,,,,
16086,35,0,35,,,,
9697,2,5,7,,,,
11956,3,2,5,,,,
12587,4,10,14,,,,
13245,5,22,27,,,,
273,9,8,17,,,,
8819,23,46,69,,,,
17043,8,0,8,,,,
15743,1,4,5,,,,
8694,8,1,9,,,,
17660,1,1,2,,,,
12392,29,22,51,,,,
11330,82,27,109,,,,
2960,5,3,8,,,,
8474,49,13,62,,,,
12666,6,5,11,,,,
9009,5,10,15,,,,
9467,4,2,6,,,,
12097,7,7,14,,,,
14005,8,12,20,,,,
7090,56,1,57,,,,
6912,30,4,34,,,,
12174,2,0,2,,,,
9148,7,2,9,,,,
3217,14,0,14,,,,
15525,11,10,21,,,,
8262,12,0,12,,,,
9809,8,10,18,,,,
8270,3,67,70,,,,
9140,2,2,4,,,,
656,4,28,32,,,,
17720,1,1,2,,,,
9104,25,0,25,,,,
941,10,9,19,,,,
3312,42,26,68,,,,
16413,13,10,23,,,,
7144,134,9,143,,,,
10265,2,19,21,,,,
15357,1,4,5,,,,
6420,132,87,219,,,,
4563,12,12,24,,,,
3402,17,4,21,,,,
17272,20,0,20,,,,
4759,12,40,52,,,,
16836,17,8,25,,,,
15275,3,7,10,,,,
6290,12,0,12,,,,
13603,9,1,10,,,,
14247,1,5,6,,,,
7891,11,12,23,,,,
16388,11,1,12,,,,
6469,2,18,20,,,,
7040,2,9,11,,,,
16276,1,12,13,,,,
1051,48,14,62,,,,
1568,100,15,115,,,,
7681,1,3,4,,,,
12595,6,6,12,,,,
12791,1,1,2,,,,
3230,3,9,12,,,,
2808,1,0,1,,,,
17037,26,13,39,,,,
14252,2,1,3,,,,
1636,322,71,393,,,,
17484,11,1,12,,,,
8110,5,2,7,,,,
2608,1,39,40,,,,
16518,2,5,7,,,,
5423,80,116,196,,,,
6674,42,37,79,,,,
5285,2,6,8,,,,
12588,14,2,16,,,,
915,18,9,27,,,,
10974,5,6,11,,,,
13684,5,1,6,,,,
9735,9,15,24,,,,
7945,172,8,180,,,,
2146,14,22,36,,,,
16994,2,6,8,,,,
5846,2,5,7,,,,
3424,12,26,38,,,,
17649,2,1,3,,,,
15664,11,6,17,,,,
3331,22,0,22,,,,
5964,10,3,13,,,,
5043,5,2,7,,,,
14814,2,27,29,,,,
16437,1,2,3,,,,
15034,3,2,5,,,,
17439,1,1,2,,,,
6785,15,23,38,,,,
1883,5,64,69,,,,
9672,1,0,1,,,,
7572,11,8,19,,,,
15454,13,4,17,,,,
4879,5,13,18,,,,
15500,2,22,24,,,,
7092,8,9,17,,,,
2514,18,0,18,,,,
8646,14,3,17,,,,
11082,4,6,10,,,,
14454,8,22,30,,,,
6355,18,38,56,,,,
9929,15,3,18,,,,
16811,3,2,5,,,,
4042,6,3,9,,,,
15436,1,9,10,,,,
15926,11,1,12,,,,
12411,11,10,21,,,,
16039,51,3,54,,,,
6799,12,60,72,,,,
6388,1,10,11,,,,
14392,1,7,8,,,,
14072,5,9,14,,,,
11589,2,2,4,,,,
1002,9,7,16,,,,
13917,10,15,25,,,,
5377,210,4,214,,,,
10370,27,0,27,,,,
2600,52,37,89,,,,
8350,2,3,5,,,,
7960,8,2,10,,,,
8420,22,16,38,,,,
13179,28,16,44,,,,
4139,10,0,10,,,,
4225,19,34,53,,,,
6490,28,26,54,,,,
4055,3,7,10,,,,
10804,14,2,16,,,,
9385,9,0,9,,,,
763,150,58,208,,,,
3066,51,5,56,,,,
3664,12,0,12,,,,
15713,9,0,9,,,,
10697,2,221,223,,,,
15810,1,0,1,,,,
13365,6,16,22,,,,
15706,13,11,24,,,,
2527,18,3,21,,,,
959,6,17,23,,,,
15740,7,0,7,,,,
3602,3,10,13,,,,
1280,13,0,13,,,,
7073,5,5,10,,,,
8112,2,1,3,,,,
14540,26,15,41,,,,
14692,5,23,28,,,,
9937,4,5,9,,,,
318,2,4,6,,,,
4735,9,23,32,,,,
5111,14,66,80,,,,
8588,6,15,21,,,,
6023,3,16,19,,,,
10361,8,22,30,,,,
1217,11,5,16,,,,
3554,7,3,10,,,,
9096,26,37,63,,,,
7678,17,12,29,,,,
13983,3,2,5,,,,
4445,1,0,1,,,,
970,10,23,33,,,,
2027,2,12,14,,,,
9303,20,5,25,,,,
15914,2,2,4,,,,
8524,47,33,80,,,,
8323,1,1,2,,,,
4072,10,35,45,,,,
10877,9,15,24,,,,
15140,7,0,7,,,,
12524,9,15,24,,,,
13306,4,4,8,,,,
5433,154,56,210,,,,
8930,1,5,6,,,,
17072,16,2,18,,,,
15967,13,6,19,,,,
13390,8,4,12,,,,
17404,2,18,20,,,,
7925,35,27,62,,,,
5668,1,20,21,,,,
2531,56,13,69,,,,
857,6,2,8,,,,
16356,2,2,4,,,,
10633,22,88,110,,,,
12367,13,5,18,,,,
220,35,0,35,,,,
1075,2,3,5,,,,
8353,7,0,7,,,,
9957,3,9,12,,,,
207,16,87,103,,,,
9464,6,0,6,,,,
13384,1,19,20,,,,
7372,7,8,15,,,,
10359,3,4,7,,,,
8394,5,1,6,,,,
3947,2,11,13,,,,
14641,2,0,2,,,,
15776,2,10,12,,,,
5321,15,7,22,,,,
8021,3,5,8,,,,
8228,17,105,122,,,,
9974,1,14,15,,,,
6011,4,5,9,,,,
15519,5,3,8,,,,
13326,2,3,5,,,,
4536,26,47,73,,,,
15640,1,7,8,,,,
14495,6,13,19,,,,
2294,11,109,120,,,,
15796,5,3,8,,,,
15038,5,2,7,,,,
9093,2,5,7,,,,
1302,18,55,73,,,,
9077,41,33,74,,,,
14470,9,4,13,,,,
17473,9,3,12,,,,
1985,100,72,172,,,,
12825,32,17,49,,,,
14750,3,4,7,,,,
5276,7,4,11,,,,
9306,8,8,16,,,,
9949,9,10,19,,,,
3240,14,17,31,,,,
14580,23,4,27,,,,
12917,33,1,34,,,,
122,8,9,17,,,,
13843,1,5,6,,,,
8080,8,1,9,,,,
7110,2,10,12,,,,
17128,23,1,24,,,,
15828,2,0,2,,,,
10936,1,7,8,,,,
5561,12,27,39,,,,
15798,3,0,3,,,,
5086,4,1,5,,,,
8372,39,0,39,,,,
6821,4,0,4,,,,
9559,18,34,52,,,,
1218,1,2,3,,,,
171,8,8,16,,,,
6686,3,8,11,,,,
14107,9,10,19,,,,
17129,8,16,24,,,,
6802,11,9,20,,,,
15481,3,18,21,,,,
9053,3,3,6,,,,
11353,3,1,4,,,,
16324,2,3,5,,,,
10720,1,2,3,,,,
6233,55,205,260,,,,
7555,58,24,82,,,,
12212,8,7,15,,,,
11565,10,1,11,,,,
2373,33,7,40,,,,
7993,11,3,14,,,,
6080,7,5,12,,,,
5932,11,4,15,,,,
1850,26,4,30,,,,
13151,4,3,7,,,,
5775,4,6,10,,,,
2374,80,75,155,,,,
11509,34,35,69,,,,
9830,1,7,8,,,,
12272,2,14,16,,,,
9883,4,1,5,,,,
12187,12,14,26,,,,
16632,3,2,5,,,,
5051,3,20,23,,,,
7168,7,9,16,,,,
17474,7,3,10,,,,
10389,2,0,2,,,,
12138,13,1,14,,,,
7812,4,4,8,,,,
16346,1,2,3,,,,
12691,2,5,7,,,,
11824,16,19,35,,,,
13521,7,20,27,,,,
8965,19,41,60,,,,
11383,11,10,21,,,,
8595,19,0,19,,,,
10986,3,1,4,,,,
9001,8,18,26,,,,
8931,38,2,40,,,,
3792,1,7,8,,,,
12434,12,2,14,,,,
16908,3,28,31,,,,
8386,3,0,3,,,,
1971,4,37,41,,,,
12409,8,13,21,,,,
5790,2,18,20,,,,
13660,1,0,1,,,,
1409,103,48,151,,,,
4261,22,36,58,,,,
999,7,9,16,,,,
1963,1,26,27,,,,
15415,25,21,46,,,,
8264,40,0,40,,,,
9588,24,3,27,,,,
10552,45,13,58,,,,
10762,8,0,8,,,,
3343,22,1,23,,,,
6635,7,15,22,,,,
16900,1,5,6,,,,
14441,9,4,13,,,,
2611,53,96,149,,,,
110,209,80,289,,,,
183,31,55,86,,,,
16931,2,2,4,,,,
3964,5,10,15,,,,
1591,24,116,140,,,,
12590,28,10,38,,,,
486,5,2,7,,,,
3225,62,145,207,,,,
12082,7,8,15,,,,
6888,12,15,27,,,,
6168,6,93,99,,,,
1687,108,11,119,,,,
10440,1,2,3,,,,
8424,50,19,69,,,,
14922,19,17,36,,,,
6672,93,33,126,,,,
11723,20,13,33,,,,
3106,41,5,46,,,,
16872,5,0,5,,,,
15464,4,2,6,,,,
3659,1,98,99,,,,
11763,19,24,43,,,,
5136,8,1,9,,,,
4259,10,14,24,,,,
16905,10,11,21,,,,
3652,57,8,65,,,,
8652,23,12,35,,,,
8838,21,1,22,,,,
15122,6,4,10,,,,
14830,17,26,43,,,,
4665,33,9,42,,,,
11258,5,5,10,,,,
5040,6,11,17,,,,
184,23,69,92,,,,
8641,1,1,2,,,,
10193,7,4,11,,,,
13611,3,4,7,,,,
14873,6,0,6,,,,
15882,1,4,5,,,,
737,59,27,86,,,,
2035,3,3,6,,,,
5777,3,33,36,,,,
10302,10,3,13,,,,
3462,7,21,28,,,,
14954,8,15,23,,,,
5517,24,69,93,,,,
7676,17,7,24,,,,
3186,3,120,123,,,,
7669,14,15,29,,,,
8655,13,1,14,,,,
3613,1,1,2,,,,
17691,1,4,5,,,,
5494,6,10,16,,,,
4018,2,12,14,,,,
14926,7,4,11,,,,
5672,6,23,29,,,,
8699,12,15,27,,,,
543,30,5,35,,,,
11724,34,6,40,,,,
10973,6,10,16,,,,
3168,11,0,11,,,,
5508,19,22,41,,,,
14667,37,33,70,,,,
14003,22,27,49,,,,
14512,2,5,7,,,,
2248,11,5,16,,,,
9727,5,8,13,,,,
5896,3,1,4,,,,
1756,70,46,116,,,,
119,84,21,105,,,,
6547,14,32,46,,,,
11778,2,24,26,,,,
2672,14,1,15,,,,
4305,6,14,20,,,,
1840,18,129,147,,,,
5413,56,134,190,,,,
2629,125,15,140,,,,
10952,4,5,9,,,,
2026,2,4,6,,,,
1994,11,11,22,,,,
773,6,2,8,,,,
17172,12,6,18,,,,
2648,11,14,25,,,,
7455,1,2,3,,,,
14607,24,3,27,,,,
14176,34,5,39,,,,
6157,36,21,57,,,,
4187,6,12,18,,,,
3281,56,21,77,,,,
12710,2,25,27,,,,
17353,16,1,17,,,,
301,103,8,111,,,,
1063,13,26,39,,,,
3216,3,1,4,,,,
7008,10,2,12,,,,
14042,2,9,11,,,,
2574,1,10,11,,,,
668,58,5,63,,,,
7588,1,3,4,,,,
12431,32,7,39,,,,
188,9,19,28,,,,
1190,11,28,39,,,,
14564,73,2,75,,,,
4602,1,6,7,,,,
13978,10,3,13,,,,
2513,3,7,10,,,,
5484,48,160,208,,,,
11568,3,0,3,,,,
17197,3,0,3,,,,
16165,54,14,68,,,,
6122,10,9,19,,,,
7363,9,0,9,,,,
6931,43,13,56,,,,
2399,78,76,154,,,,
9852,170,10,180,,,,
6263,32,28,60,,,,
17234,10,3,13,,,,
2922,72,9,81,,,,
12493,9,25,34,,,,
1417,36,35,71,,,,
939,20,5,25,,,,
13469,1,12,13,,,,
17827,1,5,6,,,,
1876,73,99,172,,,,
3594,1,9,10,,,,
14697,31,8,39,,,,
4637,1,13,14,,,,
9568,2,31,33,,,,
8066,1,6,7,,,,
7384,2,12,14,,,,
7218,19,7,26,,,,
5038,32,16,48,,,,
17516,7,0,7,,,,
13728,2,2,4,,,,
7617,12,5,17,,,,
1123,9,9,18,,,,
5726,1,1,2,,,,
15790,6,8,14,,,,
17333,4,6,10,,,,
4234,3,9,12,,,,
11562,5,16,21,,,,
8788,32,32,64,,,,
16664,2,2,4,,,,
5273,22,8,30,,,,
15749,1,8,9,,,,
5636,2,5,7,,,,
9026,50,7,57,,,,
13892,12,16,28,,,,
14527,7,19,26,,,,
10099,7,28,35,,,,
4567,43,7,50,,,,
14469,2,5,7,,,,
2307,61,3,64,,,,
8117,3,0,3,,,,
3648,5,9,14,,,,
14051,8,2,10,,,,
14555,49,10,59,,,,
288,2,0,2,,,,
3525,16,8,24,,,,
308,1,7,8,,,,
834,14,111,125,,,,
11254,5,29,34,,,,
17317,3,1,4,,,,
5549,7,24,31,,,,
13415,10,6,16,,,,
2526,3,12,15,,,,
4399,8,17,25,,,,
9196,8,21,29,,,,
9850,97,97,194,,,,
6431,46,20,66,,,,
6123,4,16,20,,,,
12435,35,38,73,,,,
3845,1,2,3,,,,
15283,65,14,79,,,,
11410,1,1,2,,,,
8023,8,14,22,,,,
17780,4,15,19,,,,
13831,3,1,4,,,,
9658,1,23,24,,,,
15431,23,13,36,,,,
17057,5,15,20,,,,
13283,2,2,4,,,,
8770,3,4,7,,,,
12146,9,25,34,,,,
5488,59,8,67,,,,
15587,3,2,5,,,,
17267,4,5,9,,,,
13739,1,7,8,,,,
11416,1,12,13,,,,
294,1,2,3,,,,
16366,10,5,15,,,,
10678,5,1,6,,,,
2302,20,31,51,,,,
7831,5,45,50,,,,
7726,7,1,8,,,,
6381,19,4,23,,,,
10227,12,2,14,,,,
13201,25,34,59,,,,
12866,6,2,8,,,,
7129,39,3,42,,,,
14546,61,1,62,,,,
10734,6,8,14,,,,
4180,11,8,19,,,,
13121,39,19,58,,,,
4560,37,26,63,,,,
1022,33,25,58,,,,
2689,59,3,62,,,,
8507,1,10,11,,,,
8389,5,22,27,,,,
8613,11,2,13,,,,
17207,5,11,16,,,,
17783,11,4,15,,,,
3631,5,3,8,,,,
502,6,0,6,,,,
2820,13,13,26,,,,
167,341,51,392,,,,
13941,10,12,22,,,,
9456,1,3,4,,,,
6219,3,17,20,,,,
16150,2,24,26,,,,
8858,7,1,8,,,,
4807,6,29,35,,,,
5034,2,0,2,,,,
15687,7,1,8,,,,
12725,3,13,16,,,,
16233,7,2,9,,,,
16880,7,1,8,,,,
17743,6,9,15,,,,
11508,13,48,61,,,,
13463,4,2,6,,,,
6516,55,25,80,,,,
15486,2,5,7,,,,
10865,2,0,2,,,,
11121,21,26,47,,,,
17446,3,1,4,,,,
12910,2,4,6,,,,
1212,12,17,29,,,,
10557,9,15,24,,,,
15239,10,2,12,,,,
17411,1,0,1,,,,
1706,72,51,123,,,,
474,9,13,22,,,,
700,45,48,93,,,,
3248,86,106,192,,,,
15016,10,16,26,,,,
16930,5,0,5,,,,
1135,2,0,2,,,,
12512,37,26,63,,,,
17016,1,2,3,,,,
13566,15,8,23,,,,
4201,39,23,62,,,,
14878,29,30,59,,,,
17692,1,2,3,,,,
256,17,0,17,,,,
7119,1,22,23,,,,
1670,62,70,132,,,,
16177,3,1,4,,,,
3782,12,15,27,,,,
4038,18,70,88,,,,
13243,46,44,90,,,,
17713,8,0,8,,,,
1141,14,7,21,,,,
1864,8,225,233,,,,
6502,6,85,91,,,,
15152,11,8,19,,,,
738,10,1,11,,,,
2413,68,100,168,,,,
13511,19,2,21,,,,
8824,25,2,27,,,,
548,14,14,28,,,,
16344,13,1,14,,,,
14246,1,0,1,,,,
14738,44,39,83,,,,
15842,3,1,4,,,,
10195,2,22,24,,,,
14269,1,0,1,,,,
15032,3,0,3,,,,
10922,1,2,3,,,,
9664,14,9,23,,,,
3357,20,14,34,,,,
8042,4,8,12,,,,
3318,176,14,190,,,,
2080,70,169,239,,,,
4802,5,43,48,,,,
2941,39,33,72,,,,
11402,3,3,6,,,,
13493,7,5,12,,,,
9865,38,6,44,,,,
4648,7,6,13,,,,
2106,30,15,45,,,,
6725,5,0,5,,,,
825,1,12,13,,,,
11525,7,2,9,,,,
5686,6,41,47,,,,
7608,18,8,26,,,,
13833,4,1,5,,,,
12677,11,1,12,,,,
12974,18,22,40,,,,
8975,20,18,38,,,,
3396,3,1,4,,,,
14059,15,6,21,,,,
6620,10,17,27,,,,
12676,9,7,16,,,,
1016,4,2,6,,,,
12678,3,13,16,,,,
77,40,111,151,,,,
4928,12,2,14,,,,
13635,5,3,8,,,,
8669,1,9,10,,,,
13975,1,9,10,,,,
10415,18,7,25,,,,
14633,4,0,4,,,,
6332,35,3,38,,,,
9766,7,3,10,,,,
3366,6,19,25,,,,
17854,1,0,1,,,,
16998,1,1,2,,,,
12469,3,10,13,,,,
13865,8,5,13,,,,
1942,20,19,39,,,,
3779,1,3,4,,,,
1393,60,271,331,,,,
3914,35,17,52,,,,
64,80,136,216,,,,
3700,1,1,2,,,,
1976,18,87,105,,,,
12436,25,60,85,,,,
6246,3,17,20,,,,
15419,8,14,22,,,,
11670,16,11,27,,,,
6289,5,13,18,,,,
12477,11,75,86,,,,
11715,26,16,42,,,,
10368,2,2,4,,,,
9078,4,20,24,,,,
14226,7,0,7,,,,
6193,5,13,18,,,,
11430,2,4,6,,,,
6942,7,1,8,,,,
1290,63,13,76,,,,
9159,1,0,1,,,,
4756,21,3,24,,,,
11836,6,10,16,,,,
17210,14,0,14,,,,
13424,27,1,28,,,,
17742,10,1,11,,,,
5969,4,1,5,,,,
6018,5,2,7,,,,
14772,6,16,22,,,,
7378,62,100,162,,,,
7958,9,35,44,,,,
4686,22,26,48,,,,
2680,26,14,40,,,,
10164,2,5,7,,,,
14568,5,10,15,,,,
9151,3,8,11,,,,
15177,2,1,3,,,,
16200,6,16,22,,,,
2990,22,70,92,,,,
2844,1,7,8,,,,
3132,32,12,44,,,,
10299,1,22,23,,,,
11155,3,8,11,,,,
8644,6,0,6,,,,
13354,2,11,13,,,,
6916,1,6,7,,,,
17206,1,7,8,,,,
4995,13,16,29,,,,
373,15,21,36,,,,
478,48,54,102,,,,
4872,1,4,5,,,,
1378,124,0,124,,,,
6618,22,5,27,,,,
17551,1,7,8,,,,
8720,4,6,10,,,,
4206,18,3,21,,,,
1927,56,54,110,,,,
4129,67,9,76,,,,
2093,2,3,5,,,,
16673,2,15,17,,,,
7285,3,7,10,,,,
12613,5,15,20,,,,
11923,2,3,5,,,,
2021,25,5,30,,,,
14569,8,32,40,,,,
11745,12,5,17,,,,
2165,5,1,6,,,,
11785,15,4,19,,,,
7869,37,7,44,,,,
8833,1,2,3,,,,
13712,6,0,6,,,,
14161,23,1,24,,,,
11080,6,11,17,,,,
14962,33,22,55,,,,
15462,2,5,7,,,,
4746,12,8,20,,,,
11908,2,19,21,,,,
5696,73,76,149,,,,
10641,3,3,6,,,,
3976,43,7,50,,,,
3263,4,40,44,,,,
11531,5,6,11,,,,
5535,5,7,12,,,,
10652,4,7,11,,,,
8989,11,34,45,,,,
1714,66,37,103,,,,
1351,19,24,43,,,,
15772,4,14,18,,,,
1959,7,50,57,,,,
11198,13,17,30,,,,
17621,7,2,9,,,,
4850,1,31,32,,,,
2943,4,2,6,,,,
2318,2,19,21,,,,
7924,14,13,27,,,,
2483,31,7,38,,,,
15573,5,2,7,,,,
4214,4,9,13,,,,
919,13,55,68,,,,
2695,1,7,8,,,,
15806,20,1,21,,,,
7286,13,17,30,,,,
2487,1,18,19,,,,
4431,4,4,8,,,,
9717,2,2,4,,,,
2407,39,131,170,,,,
11272,10,45,55,,,,
8523,19,90,109,,,,
5822,5,37,42,,,,
13952,1,3,4,,,,
17077,4,0,4,,,,
5169,2,11,13,,,,
7974,3,6,9,,,,
3868,6,26,32,,,,
7267,4,4,8,,,,
16690,9,9,18,,,,
529,71,209,280,,,,
359,8,3,11,,,,
8783,43,17,60,,,,
4861,8,6,14,,,,
14821,13,1,14,,,,
13212,29,12,41,,,,
8957,6,69,75,,,,
11096,12,2,14,,,,
9270,29,17,46,,,,
9887,6,21,27,,,,
1849,95,77,172,,,,
861,2,17,19,,,,
17160,9,0,9,,,,
6920,12,15,27,,,,
67,12,43,55,,,,
6269,10,0,10,,,,
14613,14,1,15,,,,
1450,13,0,13,,,,
13232,23,14,37,,,,
13796,2,39,41,,,,
15108,22,2,24,,,,
86,35,25,60,,,,
15294,18,18,36,,,,
6685,2,2,4,,,,
14323,12,5,17,,,,
12709,3,1,4,,,,
12679,7,4,11,,,,
671,15,59,74,,,,
12787,2,0,2,,,,
14274,5,2,7,,,,
11343,115,51,166,,,,
6171,55,20,75,,,,
17204,26,5,31,,,,
13524,21,8,29,,,,
2113,20,6,26,,,,
622,77,5,82,,,,
8272,24,12,36,,,,
16593,6,0,6,,,,
14352,7,4,11,,,,
15111,10,3,13,,,,
14825,31,32,63,,,,
9651,3,0,3,,,,
8649,1,10,11,,,,
11124,1,2,3,,,,
404,23,98,121,,,,
11176,4,16,20,,,,
2131,1,0,1,,,,
4772,28,7,35,,,,
3085,12,11,23,,,,
10629,6,21,27,,,,
17127,15,6,21,,,,
10069,4,9,13,,,,
11486,8,45,53,,,,
6212,5,5,10,,,,
16877,2,6,8,,,,
6705,1,33,34,,,,
1970,19,10,29,,,,
8043,32,1,33,,,,
14791,1,17,18,,,,
9073,43,6,49,,,,
4960,6,0,6,,,,
2946,20,12,32,,,,
4281,4,2,6,,,,
9436,4,2,6,,,,
6266,75,47,122,,,,
12081,8,10,18,,,,
9593,8,9,17,,,,
6279,224,35,259,,,,
1388,45,45,90,,,,
419,15,10,25,,,,
7433,9,5,14,,,,
11741,16,10,26,,,,
13371,8,8,16,,,,
3627,15,1,16,,,,
11483,9,10,19,,,,
5692,2,6,8,,,,
14219,7,5,12,,,,
12885,13,7,20,,,,
1871,24,44,68,,,,
13702,28,0,28,,,,
4373,146,36,182,,,,
12571,3,6,9,,,,
10397,6,16,22,,,,
16354,16,17,33,,,,
16906,2,4,6,,,,
5208,20,26,46,,,,
15757,6,10,16,,,,
2116,2,14,16,,,,
2322,58,83,141,,,,
11766,17,35,52,,,,
6350,4,17,21,,,,
14393,4,1,5,,,,
11959,36,10,46,,,,
8336,9,8,17,,,,
11612,3,5,8,,,,
16670,20,3,23,,,,
6436,10,7,17,,,,
1087,5,2,7,,,,
17493,5,1,6,,,,
14053,15,49,64,,,,
2979,35,3,38,,,,
9013,5,1,6,,,,
3259,93,7,100,,,,
12008,39,36,75,,,,
12620,14,8,22,,,,
15896,1,7,8,,,,
2692,3,1,4,,,,
4601,7,14,21,,,,
13297,1,2,3,,,,
3836,7,10,17,,,,
12545,33,40,73,,,,
1583,8,21,29,,,,
5566,20,39,59,,,,
8528,66,27,93,,,,
9180,10,6,16,,,,
16576,1,18,19,,,,
7535,46,25,71,,,,
14882,22,11,33,,,,
9075,22,19,41,,,,
16290,8,1,9,,,,
6706,5,13,18,,,,
5832,45,17,62,,,,
16761,29,23,52,,,,
5774,4,3,7,,,,
15742,2,26,28,,,,
4828,3,5,8,,,,
9984,5,0,5,,,,
10685,13,4,17,,,,
9365,16,4,20,,,,
10053,61,63,124,,,,
12155,5,6,11,,,,
15041,14,8,22,,,,
2217,4,8,12,,,,
14306,3,13,16,,,,
9189,50,21,71,,,,
6783,6,0,6,,,,
6300,11,6,17,,,,
6584,2,2,4,,,,
10847,2,2,4,,,,
6981,2,3,5,,,,
2050,12,15,27,,,,
6815,11,13,24,,,,
11549,4,5,9,,,,
3316,21,40,61,,,,
2357,8,6,14,,,,
17444,5,4,9,,,,
13407,2,1,3,,,,
2972,25,16,41,,,,
14915,16,4,20,,,,
43,1,11,12,,,,
3718,13,1,14,,,,
15524,9,33,42,,,,
6328,96,63,159,,,,
11599,2,7,9,,,,
9064,2,2,4,,,,
14436,3,2,5,,,,
180,250,45,295,,,,
4615,4,4,8,,,,
5310,3,28,31,,,,
1507,9,0,9,,,,
16945,2,0,2,,,,
4087,4,11,15,,,,
343,6,5,11,,,,
15397,20,27,47,,,,
5354,116,99,215,,,,
15403,26,22,48,,,,
873,29,18,47,,,,
4183,14,16,30,,,,
11044,3,8,11,,,,
15204,2,4,6,,,,
2208,11,7,18,,,,
11601,19,11,30,,,,
1540,2,4,6,,,,
12341,21,39,60,,,,
5077,14,4,18,,,,
12602,26,4,30,,,,
5251,17,11,28,,,,
12907,5,1,6,,,,
8546,3,5,8,,,,
2350,20,13,33,,,,
11713,14,13,27,,,,
8712,12,2,14,,,,
11973,1,4,5,,,,
6007,6,5,11,,,,
3051,67,27,94,,,,
12503,7,14,21,,,,
10403,10,9,19,,,,
1019,17,12,29,,,,
983,5,17,22,,,,
17838,2,8,10,,,,
16325,3,0,3,,,,
3182,46,92,138,,,,
12918,14,7,21,,,,
16439,4,2,6,,,,
12582,14,0,14,,,,
8508,8,20,28,,,,
6116,9,17,26,,,,
4191,4,5,9,,,,
8491,3,21,24,,,,
8889,3,0,3,,,,
13578,6,10,16,,,,
16166,6,27,33,,,,
14052,33,18,51,,,,
7756,13,3,16,,,,
11249,3,5,8,,,,
9783,13,2,15,,,,
7425,10,0,10,,,,
5080,13,8,21,,,,
7125,13,6,19,,,,
16138,25,3,28,,,,
2020,5,7,12,,,,
2751,6,5,11,,,,
17085,2,4,6,,,,
1843,26,25,51,,,,
7009,6,3,9,,,,
12159,2,1,3,,,,
8874,18,5,23,,,,
6173,12,3,15,,,,
8310,1,6,7,,,,
4621,2,4,6,,,,
4332,24,75,99,,,,
7354,1,1,2,,,,
4612,3,12,15,,,,
16162,7,9,16,,,,
9827,12,3,15,,,,
9663,12,47,59,,,,
5515,125,54,179,,,,
9980,4,0,4,,,,
16436,8,8,16,,,,
575,5,1,6,,,,
9778,3,2,5,,,,
2821,1,0,1,,,,
15982,9,3,12,,,,
17105,1,0,1,,,,
8022,18,6,24,,,,
11372,3,1,4,,,,
1145,4,0,4,,,,
11938,16,0,16,,,,
13350,7,2,9,,,,
2698,40,29,69,,,,
2612,20,85,105,,,,
1395,28,1,29,,,,
6366,10,6,16,,,,
13701,1,2,3,,,,
13730,11,0,11,,,,
1768,14,69,83,,,,
13476,2,4,6,,,,
1777,5,35,40,,,,
7944,15,64,79,,,,
6418,49,49,98,,,,
979,8,3,11,,,,
15272,2,6,8,,,,
9192,15,2,17,,,,
13206,12,15,27,,,,
5238,11,39,50,,,,
12184,6,1,7,,,,
1553,320,75,395,,,,
16119,5,2,7,,,,
1981,4,2,6,,,,
11800,28,8,36,,,,
9326,17,14,31,,,,
1398,29,111,140,,,,
15438,4,11,15,,,,
3527,5,3,8,,,,
6774,29,22,51,,,,
909,59,101,160,,,,
14946,46,28,74,,,,
10785,4,6,10,,,,
6675,20,75,95,,,,
11924,8,0,8,,,,
12971,1,5,6,,,,
8769,3,0,3,,,,
10400,5,22,27,,,,
678,93,28,121,,,,
9286,2,7,9,,,,
17306,6,0,6,,,,
2313,14,211,225,,,,
3401,132,60,192,,,,
2720,1,15,16,,,,
4507,19,4,23,,,,
4472,6,2,8,,,,
670,117,163,280,,,,
4689,16,16,32,,,,
7710,1,8,9,,,,
375,18,6,24,,,,
16045,20,27,47,,,,
130,18,244,262,,,,
7740,21,2,23,,,,
694,9,85,94,,,,
2684,151,4,155,,,,
3763,7,4,11,,,,
4739,9,18,27,,,,
11103,11,13,24,,,,
11113,13,6,19,,,,
4860,3,3,6,,,,
14128,3,3,6,,,,
11962,5,4,9,,,,
7656,24,29,53,,,,
6312,1,4,5,,,,
13972,3,4,7,,,,
16692,8,9,17,,,,
11261,11,11,22,,,,
3028,121,24,145,,,,
3520,41,28,69,,,,
5717,22,55,77,,,,
6855,3,29,32,,,,
3590,8,1,9,,,,
689,267,66,333,,,,
3663,177,67,244,,,,
4005,53,8,61,,,,
10948,3,2,5,,,,
3179,2,15,17,,,,
15539,3,4,7,,,,
1954,4,47,51,,,,
8422,47,1,48,,,,
8029,7,12,19,,,,
14035,12,1,13,,,,
7035,5,1,6,,,,
17263,3,1,4,,,,
15448,7,3,10,,,,
4050,10,6,16,,,,
13031,3,11,14,,,,
4619,12,22,34,,,,
15031,1,5,6,,,,
290,5,18,23,,,,
7161,2,13,15,,,,
8620,25,0,25,,,,
4805,10,3,13,,,,
11245,2,5,7,,,,
4483,4,33,37,,,,
8363,3,4,7,,,,
11066,3,12,15,,,,
17470,1,18,19,,,,
9936,8,2,10,,,,
13269,12,2,14,,,,
1014,11,23,34,,,,
2643,128,37,165,,,,
8224,41,5,46,,,,
16353,23,8,31,,,,
1892,16,40,56,,,,
15423,5,8,13,,,,
5966,9,9,18,,,,
5852,5,2,7,,,,
15021,23,5,28,,,,
7790,7,6,13,,,,
6563,29,10,39,,,,
13888,1,0,1,,,,
4583,13,29,42,,,,
5279,3,22,25,,,,
9237,7,0,7,,,,
6529,11,31,42,,,,
7594,1,0,1,,,,
17489,14,7,21,,,,
16237,6,2,8,,,,
12400,1,77,78,,,,
1600,22,94,116,,,,
10178,9,1,10,,,,
15838,6,9,15,,,,
7926,7,2,9,,,,
8886,40,3,43,,,,
14944,1,0,1,,,,
6392,5,5,10,,,,
3330,1,1,2,,,,
7477,13,3,16,,,,
2970,3,6,9,,,,
16978,1,36,37,,,,
13103,6,8,14,,,,
4898,84,4,88,,,,
14917,6,2,8,,,,
13087,27,40,67,,,,
8032,2,1,3,,,,
11579,1,1,2,,,,
1865,54,0,54,,,,
8378,1,26,27,,,,
14702,24,1,25,,,,
4427,189,74,263,,,,
8471,7,21,28,,,,
12930,14,6,20,,,,
15576,1,0,1,,,,
498,2,2,4,,,,
14083,1,1,2,,,,
39,1,17,18,,,,
5695,7,5,12,,,,
8015,18,22,40,,,,
8215,3,46,49,,,,
14031,3,12,15,,,,
887,2,7,9,,,,
5472,201,7,208,,,,
6899,24,2,26,,,,
5991,11,60,71,,,,
10982,5,4,9,,,,
7637,11,3,14,,,,
12107,4,4,8,,,,
8305,1,3,4,,,,
4422,5,10,15,,,,
11333,65,116,181,,,,
10917,6,13,19,,,,
3691,2,49,51,,,,
7227,4,7,11,,,,
12622,14,1,15,,,,
7739,7,7,14,,,,
8136,93,9,102,,,,
8150,82,3,85,,,,
15458,7,2,9,,,,
5651,1,1,2,,,,
8243,5,17,22,,,,
8590,1,27,28,,,,
113,190,50,240,,,,
5017,15,26,41,,,,
17221,4,4,8,,,,
5679,19,4,23,,,,
13579,1,11,12,,,,
6231,14,3,17,,,,
6922,19,5,24,,,,
4219,2,34,36,,,,
6792,33,5,38,,,,
15786,19,24,43,,,,
7146,5,7,12,,,,
15691,6,3,9,,,,
13150,7,37,44,,,,
16001,29,10,39,,,,
3644,29,6,35,,,,
14554,11,7,18,,,,
2719,100,104,204,,,,
10492,2,5,7,,,,
8144,11,7,18,,,,
11739,42,9,51,,,,
5431,62,41,103,,,,
13116,13,5,18,,,,
14669,1,14,15,,,,
16375,16,5,21,,,,
2685,83,39,122,,,,
6119,5,8,13,,,,
15889,1,1,2,,,,
13957,3,3,6,,,,
12869,8,8,16,,,,
3923,19,24,43,,,,
11878,6,16,22,,,,
3176,28,71,99,,,,
11491,81,43,124,,,,
14602,13,4,17,,,,
16953,2,0,2,,,,
17442,5,7,12,,,,
9965,12,15,27,,,,
15109,10,8,18,,,,
8024,22,4,26,,,,
6730,6,91,97,,,,
268,33,28,61,,,,
1854,33,17,50,,,,
3352,18,1,19,,,,
16485,8,6,14,,,,
6960,53,23,76,,,,
17512,4,8,12,,,,
2136,9,9,18,,,,
15096,5,9,14,,,,
17899,1,1,2,,,,
17198,5,1,6,,,,
74,128,70,198,,,,
3874,3,8,11,,,,
1737,116,41,157,,,,
11389,3,0,3,,,,
14522,1,11,12,,,,
14022,1,0,1,,,,
1414,34,98,132,,,,
17814,7,1,8,,,,
17643,1,2,3,,,,
8311,18,1,19,,,,
2905,20,1,21,,,,
15736,20,6,26,,,,
5606,18,3,21,,,,
8391,23,1,24,,,,
7052,5,1,6,,,,
10049,27,18,45,,,,
12438,31,103,134,,,,
6856,17,25,42,,,,
13995,2,1,3,,,,
7350,11,1,12,,,,
4365,10,2,12,,,,
714,5,14,19,,,,
1446,1,37,38,,,,
4117,51,24,75,,,,
16661,1,0,1,,,,
7386,2,10,12,,,,
2214,1,2,3,,,,
14966,20,0,20,,,,
13127,21,7,28,,,,
9811,3,2,5,,,,
14041,1,7,8,,,,
14296,4,12,16,,,,
13169,44,26,70,,,,
2115,16,2,18,,,,
13496,1,14,15,,,,
14869,1,1,2,,,,
13636,2,3,5,,,,
906,25,3,28,,,,
9849,14,173,187,,,,
9530,3,3,6,,,,
5318,2,76,78,,,,
5363,17,162,179,,,,
1904,3,4,7,,,,
14632,13,4,17,,,,
13671,3,3,6,,,,
9249,25,11,36,,,,
5186,1,2,3,,,,
7895,3,2,5,,,,
14698,4,3,7,,,,
2221,1,5,6,,,,
6680,48,20,68,,,,
15831,18,7,25,,,,
9271,10,9,19,,,,
11997,3,6,9,,,,
6089,2,15,17,,,,
8409,8,2,10,,,,
5283,20,15,35,,,,
16352,2,9,11,,,,
6630,11,1,12,,,,
7504,5,5,10,,,,
7638,15,11,26,,,,
7302,2,7,9,,,,
252,25,24,49,,,,
1562,100,13,113,,,,
17372,2,6,8,,,,
5124,6,4,10,,,,
445,4,0,4,,,,
8018,12,14,26,,,,
5204,58,12,70,,,,
13397,34,41,75,,,,
9014,21,36,57,,,,
8236,30,11,41,,,,
14953,44,9,53,,,,
2342,22,33,55,,,,
8626,1,8,9,,,,
16890,2,14,16,,,,
11832,46,33,79,,,,
3953,18,11,29,,,,
4447,2,11,13,,,,
15940,2,2,4,,,,
8572,9,0,9,,,,
17275,9,3,12,,,,
9845,33,168,201,,,,
2798,1,18,19,,,,
3435,23,70,93,,,,
9072,17,27,44,,,,
13929,2,0,2,,,,
17098,2,0,2,,,,
14475,3,3,6,,,,
2173,2,23,25,,,,
12226,14,2,16,,,,
3987,7,1,8,,,,
13466,46,1,47,,,,
6333,7,8,15,,,,
14429,8,3,11,,,,
14421,66,11,77,,,,
11680,10,55,65,,,,
1781,31,70,101,,,,
4722,21,18,39,,,,
7971,7,5,12,,,,
7978,33,21,54,,,,
13744,5,22,27,,,,
441,5,107,112,,,,
7520,3,9,12,,,,
24,1,13,14,,,,
5644,11,1,12,,,,
17595,13,7,20,,,,
11097,11,11,22,,,,
3317,1,53,54,,,,
11326,150,17,167,,,,
12268,3,6,9,,,,
3977,8,211,219,,,,
5022,2,30,32,,,,
1923,105,63,168,,,,
6711,7,20,27,,,,
12314,1,4,5,,,,
1292,9,40,49,,,,
17289,7,2,9,,,,
11045,18,6,24,,,,
693,98,64,162,,,,
5306,12,10,22,,,,
12088,2,15,17,,,,
1698,24,171,195,,,,
12352,3,5,8,,,,
16517,5,2,7,,,,
900,3,20,23,,,,
10758,5,7,12,,,,
3188,15,43,58,,,,
3634,40,5,45,,,,
3869,6,15,21,,,,
14680,4,0,4,,,,
11200,2,2,4,,,,
11835,16,3,19,,,,
13394,1,0,1,,,,
15976,16,10,26,,,,
2633,21,95,116,,,,
11624,4,9,13,,,,
17026,6,5,11,,,,
11682,15,27,42,,,,
2278,13,18,31,,,,
1177,30,1,31,,,,
14993,2,9,11,,,,
15854,7,5,12,,,,
13044,3,7,10,,,,
8427,14,1,15,,,,
14719,2,4,6,,,,
11555,17,6,23,,,,
1397,8,136,144,,,,
15920,2,18,20,,,,
17630,11,0,11,,,,
7586,22,24,46,,,,
11199,5,29,34,,,,
7396,71,39,110,,,,
15869,4,2,6,,,,
2239,31,25,56,,,,
731,55,56,111,,,,
13631,4,19,23,,,,
10378,9,12,21,,,,
12332,12,3,15,,,,
16574,6,5,11,,,,
14611,7,2,9,,,,
13824,5,2,7,,,,
14063,7,4,11,,,,
7049,9,24,33,,,,
6824,19,10,29,,,,
17357,11,5,16,,,,
6546,1,6,7,,,,
4792,4,28,32,,,,
10155,3,4,7,,,,
10152,2,0,2,,,,
4045,19,9,28,,,,
3934,2,13,15,,,,
15030,1,6,7,,,,
16644,4,18,22,,,,
7784,1,30,31,,,,
6272,90,83,173,,,,
15705,9,1,10,,,,
7104,15,2,17,,,,
8773,34,6,40,,,,
989,29,9,38,,,,
6773,12,50,62,,,,
5506,47,28,75,,,,
9092,21,17,38,,,,
9450,4,0,4,,,,
16866,13,0,13,,,,
11582,5,3,8,,,,
12911,11,0,11,,,,
12364,13,7,20,,,,
2219,13,1,14,,,,
8373,3,27,30,,,,
7155,1,14,15,,,,
13602,2,6,8,,,,
14303,1,2,3,,,,
3737,51,17,68,,,,
11234,2,3,5,,,,
10287,8,2,10,,,,
16780,1,3,4,,,,
12445,24,52,76,,,,
2812,2,14,16,,,,
4034,9,30,39,,,,
13795,16,24,40,,,,
6021,28,10,38,,,,
5103,25,0,25,,,,
6125,10,2,12,,,,
11095,4,30,34,,,,
7066,19,1,20,,,,
16124,7,3,10,,,,
1651,2,6,8,,,,
11698,47,4,51,,,,
845,33,22,55,,,,
12061,12,11,23,,,,
6445,59,76,135,,,,
3512,16,1,17,,,,
4016,2,5,7,,,,
644,1,126,127,,,,
4053,11,4,15,,,,
4885,7,0,7,,,,
197,34,50,84,,,,
15421,4,16,20,,,,
16703,6,0,6,,,,
2935,42,27,69,,,,
5455,126,58,184,,,,
16314,29,3,32,,,,
13050,12,36,48,,,,
12687,6,23,29,,,,
13932,10,4,14,,,,
16654,2,2,4,,,,
5203,43,22,65,,,,
7602,14,2,16,,,,
1834,116,110,226,,,,
2652,22,4,26,,,,
2182,14,1,15,,,,
12280,3,8,11,,,,
6016,16,8,24,,,,
4220,18,12,30,,,,
335,10,18,28,,,,
9875,16,5,21,,,,
17661,1,5,6,,,,
65,63,19,82,,,,
14443,3,3,6,,,,
16381,1,1,2,,,,
13246,12,8,20,,,,
13311,3,9,12,,,,
12375,8,0,8,,,,
5518,54,140,194,,,,
2365,14,18,32,,,,
3049,1,9,10,,,,
10213,46,28,74,,,,
8898,1,3,4,,,,
12462,8,0,8,,,,
7353,4,13,17,,,,
15116,3,0,3,,,,
13209,14,25,39,,,,
3308,31,232,263,,,,
8658,9,19,28,,,,
851,18,6,24,,,,
13210,14,8,22,,,,
5505,138,69,207,,,,
11042,10,12,22,,,,
14383,11,2,13,,,,
988,19,20,39,,,,
2452,33,32,65,,,,
12816,1,5,6,,,,
1057,26,18,44,,,,
8506,12,4,16,,,,
14893,15,6,21,,,,
14887,1,14,15,,,,
765,35,61,96,,,,
17264,7,11,18,,,,
11400,1,2,3,,,,
688,12,122,134,,,,
5659,8,4,12,,,,
15370,31,1,32,,,,
3080,23,29,52,,,,
10334,11,9,20,,,,
1945,20,86,106,,,,
11854,21,7,28,,,,
3959,133,50,183,,,,
4268,13,88,101,,,,
15203,1,3,4,,,,
3939,6,56,62,,,,
7795,1,6,7,,,,
2432,62,13,75,,,,
5601,15,68,83,,,,
14415,8,0,8,,,,
7419,1,9,10,,,,
1416,67,143,210,,,,
3960,8,126,134,,,,
8860,6,1,7,,,,
2989,14,19,33,,,,
5078,21,4,25,,,,
16199,14,17,31,,,,
15564,3,25,28,,,,
5387,90,31,121,,,,
8303,11,0,11,,,,
15126,4,12,16,,,,
2340,102,24,126,,,,
17627,3,3,6,,,,
16552,3,8,11,,,,
15190,2,0,2,,,,
6662,19,6,25,,,,
7518,13,74,87,,,,
1291,30,154,184,,,,
2179,13,6,19,,,,
12312,17,34,51,,,,
7248,21,4,25,,,,
720,16,31,47,,,,
12985,8,7,15,,,,
12939,8,4,12,,,,
2581,15,6,21,,,,
7194,19,17,36,,,,
10712,13,1,14,,,,
10703,27,25,52,,,,
12909,1,0,1,,,,
6688,10,20,30,,,,
12105,2,14,16,,,,
17381,3,5,8,,,,
14933,7,7,14,,,,
16561,1,2,3,,,,
5961,2,23,25,,,,
12230,1,1,2,,,,
92,46,122,168,,,,
7375,4,0,4,,,,
12017,3,4,7,,,,
11756,3,14,17,,,,
8279,10,3,13,,,,
10813,12,14,26,,,,
10033,46,49,95,,,,
9179,8,6,14,,,,
2852,4,17,21,,,,
2120,1,3,4,,,,
9473,3,12,15,,,,
11094,10,8,18,,,,
10228,76,12,88,,,,
4785,26,2,28,,,,
11857,4,8,12,,,,
17514,1,0,1,,,,
314,2,0,2,,,,
6249,26,114,140,,,,
15816,1,0,1,,,,
9960,4,5,9,,,,
7901,19,132,151,,,,
2658,28,28,56,,,,
8535,85,14,99,,,,
17390,1,0,1,,,,
5576,11,20,31,,,,
7247,12,20,32,,,,
1030,8,5,13,,,,
13959,1,5,6,,,,
9866,10,22,32,,,,
8734,1,2,3,,,,
16488,9,1,10,,,,
5715,7,1,8,,,,
1506,109,42,151,,,,
159,55,141,196,,,,
6992,8,7,15,,,,
5626,25,0,25,,,,
8775,32,3,35,,,,
11821,18,2,20,,,,
7961,6,1,7,,,,
9413,53,12,65,,,,
17463,5,6,11,,,,
11392,7,27,34,,,,
304,21,7,28,,,,
4073,12,31,43,,,,
17861,2,1,3,,,,
6495,5,0,5,,,,
17659,3,9,12,,,,
2992,6,26,32,,,,
4353,2,12,14,,,,
11779,4,3,7,,,,
15013,4,11,15,,,,
11136,3,2,5,,,,
191,28,26,54,,,,
3794,1,16,17,,,,
3545,9,7,16,,,,
4931,2,6,8,,,,
1536,6,0,6,,,,
17011,5,8,13,,,,
4570,46,52,98,,,,
17823,7,0,7,,,,
17401,4,3,7,,,,
14466,7,9,16,,,,
698,18,22,40,,,,
5740,10,7,17,,,,
1556,21,91,112,,,,
1906,105,99,204,,,,
17322,5,1,6,,,,
6904,6,13,19,,,,
8027,6,6,12,,,,
1661,11,288,299,,,,
6952,9,3,12,,,,
10212,12,0,12,,,,
8320,30,5,35,,,,
2064,11,7,18,,,,
9045,5,3,8,,,,
8252,20,12,32,,,,
13734,12,5,17,,,,
16235,2,9,11,,,,
5237,15,25,40,,,,
8467,1,14,15,,,,
1391,32,0,32,,,,
3255,39,60,99,,,,
12952,1,1,2,,,,
14314,26,3,29,,,,
9496,7,1,8,,,,
6963,9,5,14,,,,
17246,2,16,18,,,,
302,6,5,11,,,,
13565,32,7,39,,,,
11886,4,4,8,,,,
15320,3,2,5,,,,
7919,50,2,52,,,,
17538,1,1,2,,,,
7873,21,8,29,,,,
15235,2,20,22,,,,
600,42,45,87,,,,
10024,2,18,20,,,,
6215,3,15,18,,,,
12018,135,21,156,,,,
846,3,2,5,,,,
7475,18,0,18,,,,
1595,17,8,25,,,,
6770,2,3,5,,,,
5227,17,15,32,,,,
6331,15,2,17,,,,
17620,1,2,3,,,,
311,7,3,10,,,,
390,2,3,5,,,,
7415,4,27,31,,,,
15085,1,20,21,,,,
11819,14,17,31,,,,
14601,2,3,5,,,,
7431,19,1,20,,,,
1663,66,110,176,,,,
2776,7,18,25,,,,
3025,9,17,26,,,,
13896,14,16,30,,,,
10059,69,0,69,,,,
11950,34,22,56,,,,
3933,12,19,31,,,,
7044,11,4,15,,,,
1961,50,143,193,,,,
1354,21,20,41,,,,
10281,100,19,119,,,,
15046,12,0,12,,,,
9242,14,5,19,,,,
9024,3,6,9,,,,
6299,49,48,97,,,,
12903,13,26,39,,,,
16971,2,3,5,,,,
1196,1,4,5,,,,
11382,1,28,29,,,,
15751,1,4,5,,,,
6842,9,9,18,,,,
4315,17,28,45,,,,
8609,5,1,6,,,,
7023,11,10,21,,,,
4335,9,2,11,,,,
16663,3,2,5,,,,
15844,19,8,27,,,,
15627,19,14,33,,,,
5343,162,31,193,,,,
6898,10,7,17,,,,
6028,13,1,14,,,,
10434,12,2,14,,,,
2163,6,49,55,,,,
9692,9,1,10,,,,
14150,2,33,35,,,,
13686,6,3,9,,,,
17235,4,3,7,,,,
10303,6,1,7,,,,
5008,6,2,8,,,,
11947,2,5,7,,,,
12570,2,25,27,,,,
11529,2,6,8,,,,
8941,3,30,33,,,,
6209,30,13,43,,,,
848,16,0,16,,,,
3516,1,7,8,,,,
4205,10,8,18,,,,
850,39,3,42,,,,
52,3,20,23,,,,
9221,24,4,28,,,,
1814,4,49,53,,,,
12247,3,1,4,,,,
7411,5,4,9,,,,
3276,41,125,166,,,,
8591,12,4,16,,,,
5063,17,12,29,,,,
16643,13,1,14,,,,
12589,32,7,39,,,,
3417,12,6,18,,,,
16706,6,5,11,,,,
14338,8,2,10,,,,
4081,12,10,22,,,,
3767,41,8,49,,,,
6100,62,21,83,,,,
7589,27,0,27,,,,
10456,2,4,6,,,,
15394,16,21,37,,,,
16041,31,9,40,,,,
418,18,42,60,,,,
14204,42,28,70,,,,
7266,1,6,7,,,,
6581,3,13,16,,,,
16790,3,15,18,,,,
4691,17,16,33,,,,
1077,2,3,5,,,,
7187,2,3,5,,,,
1725,115,105,220,,,,
12150,4,2,6,,,,
5973,17,4,21,,,,
9332,1,93,94,,,,
7275,12,1,13,,,,
4896,1,1,2,,,,
8877,1,2,3,,,,
8141,111,1,112,,,,
2007,3,5,8,,,,
8814,5,1,6,,,,
5157,19,22,41,,,,
10571,2,0,2,,,,
12968,3,29,32,,,,
4788,22,16,38,,,,
4719,7,13,20,,,,
681,131,21,152,,,,
4683,18,9,27,,,,
13104,35,38,73,,,,
14715,2,10,12,,,,
13919,3,3,6,,,,
8441,16,11,27,,,,
5521,14,171,185,,,,
1172,1,1,2,,,,
5936,41,8,49,,,,
15084,4,0,4,,,,
7427,1,3,4,,,,
7200,10,2,12,,,,
17434,1,0,1,,,,
15040,2,6,8,,,,
17386,3,12,15,,,,
7959,10,77,87,,,,
14146,3,15,18,,,,
16459,5,3,8,,,,
3842,153,67,220,,,,
12718,3,19,22,,,,
8721,4,11,15,,,,
6786,16,8,24,,,,
13034,2,6,8,,,,
11359,2,2,4,,,,
3369,79,2,81,,,,
12335,16,89,105,,,,
10320,27,6,33,,,,
4518,5,14,19,,,,
16228,7,11,18,,,,
3571,1,3,4,,,,
11459,3,4,7,,,,
11151,4,1,5,,,,
10086,37,8,45,,,,
15558,1,10,11,,,,
2694,20,10,30,,,,
17815,1,2,3,,,,
241,3,8,11,,,,
569,68,246,314,,,,
16146,1,7,8,,,,
3530,15,23,38,,,,
3464,7,4,11,,,,
10684,4,2,6,,,,
17324,4,1,5,,,,
7162,6,9,15,,,,
11521,18,5,23,,,,
5589,22,46,68,,,,
1131,14,22,36,,,,
13398,12,15,27,,,,
12554,1,1,2,,,,
4629,8,0,8,,,,
3468,8,22,30,,,,
15132,23,0,23,,,,
15023,5,8,13,,,,
14227,1,3,4,,,,
6203,13,10,23,,,,
13592,11,2,13,,,,
14258,3,0,3,,,,
14480,37,2,39,,,,
5035,3,7,10,,,,
21,3,6,9,,,,
8212,40,48,88,,,,
16061,2,62,64,,,,
7045,29,13,42,,,,
9909,10,4,14,,,,
17745,9,0,9,,,,
9059,10,18,28,,,,
8240,13,2,15,,,,
6323,148,31,179,,,,
13147,6,16,22,,,,
15760,5,27,32,,,,
756,36,221,257,,,,
17862,3,2,5,,,,
16642,7,18,25,,,,
12961,14,6,20,,,,
9461,23,0,23,,,,
4308,9,28,37,,,,
10605,39,4,43,,,,
7483,12,6,18,,,,
8478,1,2,3,,,,
11280,1,2,3,,,,
15451,12,0,12,,,,
10704,65,10,75,,,,
9841,14,38,52,,,,
5857,3,1,4,,,,
14861,3,2,5,,,,
11315,20,26,46,,,,
10612,16,8,24,,,,
12987,1,11,12,,,,
9355,7,3,10,,,,
6811,9,4,13,,,,
13589,2,0,2,,,,
15610,3,11,14,,,,
9512,6,10,16,,,,
4103,1,27,28,,,,
16163,9,14,23,,,,
13414,6,3,9,,,,
5770,11,15,26,,,,
16582,1,4,5,,,,
13607,29,98,127,,,,
3279,12,46,58,,,,
9163,1,0,1,,,,
1236,4,8,12,,,,
479,3,2,5,,,,
11150,9,2,11,,,,
15938,13,1,14,,,,
12200,1,3,4,,,,
8216,10,10,20,,,,
1396,56,17,73,,,,
12773,7,0,7,,,,
9000,11,47,58,,,,
13214,11,14,25,,,,
8069,5,1,6,,,,
12236,1,22,23,,,,
779,61,1,62,,,,
5187,6,3,9,,,,
16153,15,26,41,,,,
9312,8,7,15,,,,
12946,8,3,11,,,,
3918,25,45,70,,,,
5528,6,109,115,,,,
4837,5,25,30,,,,
3562,2,4,6,,,,
17270,3,14,17,,,,
1676,13,92,105,,,,
16878,3,1,4,,,,
3299,5,7,12,,,,
13393,1,0,1,,,,
9334,4,18,22,,,,
431,5,6,11,,,,
11999,85,25,110,,,,
1828,94,77,171,,,,
4786,7,10,17,,,,
8407,23,2,25,,,,
3897,28,9,37,,,,
9489,12,0,12,,,,
14657,72,0,72,,,,
3183,124,79,203,,,,
5844,52,12,64,,,,
15563,3,0,3,,,,
297,4,2,6,,,,
15352,15,1,16,,,,
15814,1,2,3,,,,
3495,3,5,8,,,,
16118,4,3,7,,,,
7171,2,6,8,,,,
6552,2,1,3,,,,
1953,70,30,100,,,,
15318,1,2,3,,,,
16273,6,2,8,,,,
1272,4,1,5,,,,
7750,4,2,6,,,,
10773,2,6,8,,,,
13764,4,8,12,,,,
9600,11,0,11,,,,
15654,26,5,31,,,,
1155,21,6,27,,,,
132,33,13,46,,,,
15788,1,9,10,,,,
9409,10,1,11,,,,
15163,13,12,25,,,,
6781,12,13,25,,,,
7568,1,22,23,,,,
17638,1,10,11,,,,
7633,7,31,38,,,,
4265,6,4,10,,,,
16747,2,4,6,,,,
15805,10,5,15,,,,
3088,1,5,6,,,,
9392,3,7,10,,,,
8118,1,0,1,,,,
10765,2,7,9,,,,
13879,33,12,45,,,,
61,48,12,60,,,,
10204,37,9,46,,,,
9054,41,17,58,,,,
11870,8,13,21,,,,
11683,43,12,55,,,,
992,9,11,20,,,,
8556,8,2,10,,,,
12951,1,8,9,,,,
8248,13,18,31,,,,
4403,4,3,7,,,,
17068,3,9,12,,,,
4452,8,15,23,,,,
4967,10,28,38,,,,
5548,1,42,43,,,,
15545,3,7,10,,,,
2595,4,2,6,,,,
2938,72,9,81,,,,
7727,3,19,22,,,,
16592,3,6,9,,,,
8194,37,11,48,,,,
9912,5,3,8,,,,
9106,10,1,11,,,,
10730,10,30,40,,,,
14792,11,0,11,,,,
11345,33,134,167,,,,
4004,35,76,111,,,,
1880,22,84,106,,,,
15249,47,2,49,,,,
5207,2,26,28,,,,
14925,10,7,17,,,,
944,20,10,30,,,,
15795,1,5,6,,,,
17099,14,13,27,,,,
958,12,2,14,,,,
3492,13,2,15,,,,
8781,14,87,101,,,,
908,17,18,35,,,,
6766,5,4,9,,,,
269,2,2,4,,,,
14299,2,5,7,,,,
14339,2,8,10,,,,
4282,61,11,72,,,,
2647,117,2,119,,,,
10873,16,32,48,,,,
576,1,1,2,,,,
4389,16,3,19,,,,
16929,1,2,3,,,,
3078,3,4,7,,,,
6722,1,2,3,,,,
11114,6,6,12,,,,
9030,73,3,76,,,,
10253,1,16,17,,,,
10875,17,5,22,,,,
14952,9,8,17,,,,
4039,3,20,23,,,,
7844,6,10,16,,,,
14900,14,2,16,,,,
6211,2,9,11,,,,
2119,34,30,64,,,,
943,17,3,20,,,,
16229,3,6,9,,,,
7466,7,16,23,,,,
13328,6,7,13,,,,
5802,6,5,11,,,,
142,11,13,24,,,,
608,40,0,40,,,,
3013,9,6,15,,,,
6184,72,89,161,,,,
10716,1,3,4,,,,
9244,8,2,10,,,,
7639,1,1,2,,,,
17279,22,1,23,,,,
11141,6,0,6,,,,
4552,20,10,30,,,,
1,33,7,40,,,,
7117,1,5,6,,,,
10096,2,19,21,,,,
6429,6,3,9,,,,
5596,7,30,37,,,,
8343,16,5,21,,,,
7761,53,0,53,,,,
965,4,6,10,,,,
10459,14,9,23,,,,
802,1,27,28,,,,
5825,2,22,24,,,,
10987,3,2,5,,,,
2231,1,5,6,,,,
10336,1,5,6,,,,
3787,7,1,8,,,,
5572,40,0,40,,,,
8261,57,35,92,,,,
4540,80,33,113,,,,
5522,90,99,189,,,,
13600,6,7,13,,,,
14206,26,57,83,,,,
12711,31,2,33,,,,
1627,101,84,185,,,,
6713,1,1,2,,,,
12100,10,0,10,,,,
14897,21,11,32,,,,
14141,2,12,14,,,,
8070,3,0,3,,,,
15059,1,0,1,,,,
2649,1,16,17,,,,
11761,17,7,24,,,,
9743,10,1,11,,,,
572,128,3,131,,,,
17286,1,10,11,,,,
6569,8,16,24,,,,
7240,2,4,6,,,,
1578,14,298,312,,,,
4908,5,3,8,,,,
16904,1,20,21,,,,
4047,1,20,21,,,,
842,93,4,97,,,,
11883,4,3,7,,,,
4703,3,51,54,,,,
228,2,13,15,,,,
10464,33,10,43,,,,
14585,3,0,3,,,,
14958,17,2,19,,,,
12259,9,1,10,,,,
12427,11,25,36,,,,
6572,4,16,20,,,,
4394,11,5,16,,,,
2860,42,34,76,,,,
4485,11,13,24,,,,
7788,40,3,43,,,,
9274,24,3,27,,,,
6149,11,9,20,,,,
4561,1,17,18,,,,
395,4,0,4,,,,
12038,2,0,2,,,,
3581,5,0,5,,,,
13451,14,6,20,,,,
15777,6,3,9,,,,
9881,23,8,31,,,,
10807,7,26,33,,,,
16705,4,22,26,,,,
5364,180,30,210,,,,
2841,1,0,1,,,,
10300,2,4,6,,,,
16958,4,2,6,,,,
7225,12,11,23,,,,
7099,2,5,7,,,,
6535,1,4,5,,,,
13749,4,9,13,,,,
8538,56,38,94,,,,
2782,4,5,9,,,,
8163,62,59,121,,,,
12250,19,6,25,,,,
14251,2,1,3,,,,
6880,4,0,4,,,,
492,57,5,62,,,,
13015,3,9,12,,,,
10894,41,47,88,,,,
13665,2,3,5,,,,
15453,4,3,7,,,,
1785,16,79,95,,,,
9705,4,0,4,,,,
13587,16,1,17,,,,
3550,3,0,3,,,,
4761,16,31,47,,,,
1520,5,11,16,,,,
3187,3,31,34,,,,
9784,1,4,5,,,,
7988,2,5,7,,,,
4000,57,24,81,,,,
3467,25,19,44,,,,
16550,4,7,11,,,,
14521,11,13,24,,,,
9211,9,1,10,,,,
14170,2,33,35,,,,
7682,1,9,10,,,,
5457,44,75,119,,,,
4980,33,5,38,,,,
16558,4,1,5,,,,
14545,57,9,66,,,,
14666,2,3,5,,,,
9737,30,17,47,,,,
8912,8,4,12,,,,
3482,10,3,13,,,,
9449,17,19,36,,,,
2762,28,1,29,,,,
468,5,3,8,,,,
1577,127,37,164,,,,
9562,20,30,50,,,,
5231,30,4,34,,,,
17852,1,0,1,,,,
1935,25,9,34,,,,
14749,2,5,7,,,,
15316,1,0,1,,,,
6924,9,0,9,,,,
14205,62,3,65,,,,
2379,37,31,68,,,,
10960,4,9,13,,,,
13638,1,0,1,,,,
1232,20,1,21,,,,
3911,6,22,28,,,,
5841,18,17,35,,,,
5365,87,102,189,,,,
6914,10,9,19,,,,
16934,2,1,3,,,,
16498,1,2,3,,,,
10883,6,34,40,,,,
15222,1,2,3,,,,
5479,94,127,221,,,,
6561,2,7,9,,,,
13482,8,24,32,,,,
10848,19,1,20,,,,
3606,64,2,66,,,,
14592,3,2,5,,,,
11955,3,6,9,,,,
4946,6,0,6,,,,
6461,47,30,77,,,,
240,7,18,25,,,,
1228,158,0,158,,,,
16765,6,0,6,,,,
4455,2,0,2,,,,
2517,5,10,15,,,,
707,82,115,197,,,,
15791,7,6,13,,,,
10831,8,6,14,,,,
72,14,41,55,,,,
1040,6,10,16,,,,
13363,18,17,35,,,,
4830,18,1,19,,,,
15972,17,2,19,,,,
3010,56,3,59,,,,
4285,13,6,19,,,,
16743,5,1,6,,,,
9425,19,13,32,,,,
2650,3,9,12,,,,
10646,1,3,4,,,,
11038,20,3,23,,,,
7911,12,2,14,,,,
726,33,2,35,,,,
8602,11,7,18,,,,
3370,5,53,58,,,,
11050,2,2,4,,,,
14223,26,0,26,,,,
15369,1,6,7,,,,
13006,13,38,51,,,,
353,3,4,7,,,,
794,57,18,75,,,,
11331,122,35,157,,,,
11518,5,11,16,,,,
1918,43,17,60,,,,
716,131,193,324,,,,
7061,24,5,29,,,,
5463,25,178,203,,,,
1248,19,2,21,,,,
12210,52,19,71,,,,
6162,4,2,6,,,,
4348,1,1,2,,,,
16938,3,5,8,,,,
4882,3,5,8,,,,
4068,58,5,63,,,,
16985,16,23,39,,,,
13946,4,9,13,,,,
7255,10,5,15,,,,
9475,4,12,16,,,,
217,19,14,33,,,,
7593,6,11,17,,,,
5940,31,24,55,,,,
836,22,14,36,,,,
13786,42,3,45,,,,
646,94,15,109,,,,
16033,33,36,69,,,,
3668,3,8,11,,,,
12179,6,9,15,,,,
865,11,7,18,,,,
11852,4,9,13,,,,
649,8,93,101,,,,
7827,10,3,13,,,,
13304,4,11,15,,,,
4769,75,5,80,,,,
16019,8,39,47,,,,
16393,19,21,40,,,,
9406,23,8,31,,,,
3628,2,1,3,,,,
4470,4,4,8,,,,
15243,15,8,23,,,,
5395,97,103,200,,,,
5397,78,79,157,,,,
17311,10,0,10,,,,
9691,9,62,71,,,,
7651,9,52,61,,,,
11492,22,46,68,,,,
17570,3,4,7,,,,
6463,22,6,28,,,,
16952,1,2,3,,,,
5945,17,8,25,,,,
13168,44,5,49,,,,
15594,8,9,17,,,,
13836,11,14,25,,,,
12197,4,1,5,,,,
15550,9,4,13,,,,
11809,3,19,22,,,,
2561,8,2,10,,,,
8726,2,5,7,,,,
4292,70,42,112,,,,
2377,90,77,167,,,,
8367,5,10,15,,,,
5913,2,2,4,,,,
2571,14,8,22,,,,
1696,77,32,109,,,,
15161,7,2,9,,,,
7352,14,8,22,,,,
11570,7,6,13,,,,
15287,8,1,9,,,,
11532,6,2,8,,,,
4586,60,3,63,,,,
11403,20,5,25,,,,
9932,19,14,33,,,,
12334,45,12,57,,,,
14450,1,3,4,,,,
17527,8,3,11,,,,
12020,5,14,19,,,,
3347,4,29,33,,,,
8064,51,9,60,,,,
1526,10,4,14,,,,
17258,16,11,27,,,,
872,57,48,105,,,,
5312,5,12,17,,,,
6951,16,3,19,,,,
12534,11,14,25,,,,
13180,35,13,48,,,,
5060,27,6,33,,,,
8663,22,4,26,,,,
1863,12,8,20,,,,
10921,21,8,29,,,,
3846,5,6,11,,,,
13357,3,2,5,,,,
459,5,0,5,,,,
6523,7,15,22,,,,
2806,16,11,27,,,,
14045,4,2,6,,,,
13280,5,2,7,,,,
3471,7,83,90,,,,
298,10,12,22,,,,
10298,10,0,10,,,,
8994,2,0,2,,,,
4733,3,30,33,,,,
14180,18,22,40,,,,
4547,24,75,99,,,,
1874,80,29,109,,,,
4294,5,28,33,,,,
11794,1,7,8,,,,
12450,128,27,155,,,,
789,27,110,137,,,,
13488,6,5,11,,,,
1043,12,38,50,,,,
13525,8,24,32,,,,
9411,6,26,32,,,,
2642,20,45,65,,,,
5042,3,1,4,,,,
12972,2,1,3,,,,
6088,5,13,18,,,,
2024,1,3,4,,,,
11792,5,27,32,,,,
5469,56,116,172,,,,
2275,85,144,229,,,,
14270,5,0,5,,,,
998,8,3,11,,,,
1490,1,7,8,,,,
1156,41,9,50,,,,
17005,2,0,2,,,,
6599,6,5,11,,,,
3268,230,146,376,,,,
8625,8,17,25,,,,
3848,5,15,20,,,,
8158,23,36,59,,,,
9550,12,52,64,,,,
2362,1,15,16,,,,
757,66,10,76,,,,
1319,116,1,117,,,,
3128,8,3,11,,,,
7507,5,12,17,,,,
7417,5,0,5,,,,
9540,1,2,3,,,,
889,25,10,35,,,,
3414,13,12,25,,,,
1758,42,30,72,,,,
8026,2,16,18,,,,
16259,7,0,7,,,,
4871,7,5,12,,,,
11048,8,4,12,,,,
13072,3,8,11,,,,
9972,43,4,47,,,,
15493,22,1,23,,,,
3661,26,0,26,,,,
17610,4,1,5,,,,
17744,3,0,3,,,,
13706,1,0,1,,,,
7916,28,16,44,,,,
14266,1,1,2,,,,
15601,6,2,8,,,,
4542,18,10,28,,,,
12611,4,9,13,,,,
509,13,1,14,,,,
10901,1,4,5,,,,
12740,2,0,2,,,,
3452,2,29,31,,,,
1665,372,0,372,,,,
12396,4,7,11,,,,
4819,7,8,15,,,,
17644,7,10,17,,,,
7922,23,60,83,,,,
9469,8,2,10,,,,
7495,69,7,76,,,,
13964,20,6,26,,,,
12998,15,12,27,,,,
17785,7,4,11,,,,
11711,15,29,44,,,,
44,10,10,20,,,,
15494,1,3,4,,,,
914,45,23,68,,,,
672,50,92,142,,,,
5950,4,0,4,,,,
17721,3,4,7,,,,
16581,5,5,10,,,,
11350,3,10,13,,,,
1633,92,48,140,,,,
10100,12,9,21,,,,
14198,26,20,46,,,,
15194,6,0,6,,,,
1705,256,7,263,,,,
9403,6,0,6,,,,
12329,7,11,18,,,,
5605,7,6,13,,,,
3478,3,16,19,,,,
12349,8,7,15,,,,
10881,6,2,8,,,,
7244,3,2,5,,,,
16159,18,20,38,,,,
3645,3,25,28,,,,
11875,1,2,3,,,,
14301,1,3,4,,,,
6889,16,3,19,,,,
2741,10,13,23,,,,
17331,1,8,9,,,,
4798,5,41,46,,,,
16553,4,8,12,,,,
10097,17,62,79,,,,
5615,2,9,11,,,,
7359,4,15,19,,,,
237,4,49,53,,,,
15485,8,2,10,,,,
15155,7,6,13,,,,
15094,5,13,18,,,,
9394,10,0,10,,,,
11825,1,18,19,,,,
1720,36,2,38,,,,
1761,18,28,46,,,,
8148,49,8,57,,,,
2017,1,2,3,,,,
5438,108,23,131,,,,
11110,6,3,9,,,,
7113,4,6,10,,,,
11881,6,3,9,,,,
9300,1,4,5,,,,
7499,12,17,29,,,,
2288,7,10,17,,,,
4080,31,6,37,,,,
12394,3,2,5,,,,
13595,5,6,11,,,,
14056,3,19,22,,,,
4153,8,3,11,,,,
4742,14,37,51,,,,
11301,6,11,17,,,,
16791,14,2,16,,,,
11648,6,11,17,,,,
10065,21,11,32,,,,
13596,17,0,17,,,,
15855,5,8,13,,,,
5741,3,10,13,,,,
11007,5,1,6,,,,
7928,35,1,36,,,,
17431,1,3,4,,,,
10007,16,3,19,,,,
14425,1,3,4,,,,
12303,1,0,1,,,,
4098,28,8,36,,,,
12428,59,21,80,,,,
16208,22,3,25,,,,
1255,12,7,19,,,,
4572,18,12,30,,,,
2166,13,37,50,,,,
5709,1,3,4,,,,
4849,30,19,49,,,,
1804,363,65,428,,,,
3711,10,6,16,,,,
5788,7,6,13,,,,
9808,1,11,12,,,,
12407,11,8,19,,,,
8498,2,9,11,,,,
4845,3,2,5,,,,
4778,11,12,23,,,,
15372,5,9,14,,,,
1822,2,4,6,,,,
6753,15,7,22,,,,
13461,32,10,42,,,,
4616,5,0,5,,,,
19,14,2,16,,,,
2240,82,13,95,,,,
6019,19,12,31,,,,
10208,3,10,13,,,,
2281,8,16,24,,,,
10021,23,5,28,,,,
8101,4,1,5,,,,
12826,7,16,23,,,,
14628,14,0,14,,,,
12274,31,34,65,,,,
2175,2,2,4,,,,
1697,31,3,34,,,,
13857,2,1,3,,,,
13138,4,3,7,,,,
1007,25,3,28,,,,
16174,4,6,10,,,,
16190,5,29,34,,,,
2813,1,1,2,,,,
12843,2,20,22,,,,
10106,2,2,4,,,,
5611,4,6,10,,,,
15552,9,13,22,,,,
5497,132,49,181,,,,
11368,14,0,14,,,,
3605,6,4,10,,,,
1031,5,7,12,,,,
3730,2,4,6,,,,
10001,13,10,23,,,,
5625,8,2,10,,,,
5403,84,124,208,,,,
17033,14,8,22,,,,
1198,2,33,35,,,,
10488,4,19,23,,,,
14995,3,1,4,,,,
1949,56,57,113,,,,
4298,46,17,63,,,,
2874,8,5,13,,,,
14711,12,12,24,,,,
15566,2,32,34,,,,
5902,1,2,3,,,,
5600,3,22,25,,,,
5946,13,12,25,,,,
16798,1,0,1,,,,
10451,6,4,10,,,,
13622,25,21,46,,,,
4528,44,54,98,,,,
17228,4,2,6,,,,
12586,11,0,11,,,,
9846,119,68,187,,,,
16855,2,23,25,,,,
1969,7,28,35,,,,
8155,33,5,38,,,,
677,24,7,31,,,,
2464,6,17,23,,,,
990,1,6,7,,,,
2548,23,3,26,,,,
1179,16,8,24,,,,
2347,15,10,25,,,,
1349,15,24,39,,,,
4154,2,6,8,,,,
835,83,47,130,,,,
5909,4,9,13,,,,
17894,8,0,8,,,,
14833,4,2,6,,,,
12669,10,0,10,,,,
4481,1,16,17,,,,
1338,32,11,43,,,,
2790,35,30,65,,,,
12277,4,3,7,,,,
14773,9,5,14,,,,
7120,16,24,40,,,,
14808,12,3,15,,,,
10690,3,10,13,,,,
12978,4,11,15,,,,
17534,2,0,2,,,,
7060,7,27,34,,,,
9786,19,1,20,,,,
1911,9,13,22,,,,
6843,28,32,60,,,,
17761,3,5,8,,,,
10462,22,23,45,,,,
6220,27,2,29,,,,
11204,2,36,38,,,,
14810,5,2,7,,,,
10042,39,24,63,,,,
14959,2,14,16,,,,
8115,1,1,2,,,,
9767,17,6,23,,,,
6956,1,3,4,,,,
5645,7,3,10,,,,
16885,4,4,8,,,,
15515,7,1,8,,,,
4859,5,4,9,,,,
10669,27,1,28,,,,
8434,16,31,47,,,,
3336,5,21,26,,,,
7917,1,8,9,,,,
17049,30,6,36,,,,
3227,32,159,191,,,,
12846,48,11,59,,,,
13943,10,1,11,,,,
16319,3,16,19,,,,
12560,2,42,44,,,,
13519,11,10,21,,,,
16565,3,1,4,,,,
17332,9,6,15,,,,
12769,20,1,21,,,,
1447,21,22,43,,,,
71,41,106,147,,,,
3875,10,57,67,,,,
1106,1,9,10,,,,
11193,18,5,23,,,,
17590,5,7,12,,,,
396,6,8,14,,,,
17223,6,23,29,,,,
10899,3,8,11,,,,
17316,6,2,8,,,,
2859,6,69,75,,,,
10926,7,13,20,,,,
15603,13,11,24,,,,
3750,4,8,12,,,,
9643,11,1,12,,,,
17681,9,1,10,,,,
7655,35,6,41,,,,
9612,39,5,44,,,,
6113,9,5,14,,,,
6527,20,11,31,,,,
11241,70,31,101,,,,
11202,26,1,27,,,,
3909,21,11,32,,,,
15565,15,11,26,,,,
12729,3,15,18,,,,
2218,6,1,7,,,,
6892,1,80,81,,,,
8932,4,2,6,,,,
7623,3,0,3,,,,
10435,6,0,6,,,,
14404,12,2,14,,,,
11160,2,1,3,,,,
936,24,14,38,,,,
7849,6,30,36,,,,
17307,5,2,7,,,,
3537,15,14,29,,,,
6684,69,38,107,,,,
10693,1,1,2,,,,
13252,2,8,10,,,,
2976,12,22,34,,,,
7652,11,0,11,,,,
662,37,27,64,,,,
7949,31,1,32,,,,
17481,2,6,8,,,,
9703,4,9,13,,,,
6304,17,5,22,,,,
2289,34,28,62,,,,
12294,1,3,4,,,,
11633,11,0,11,,,,
14590,1,0,1,,,,
1482,3,59,62,,,,
11629,15,21,36,,,,
4426,4,5,9,,,,
4884,1,5,6,,,,
12850,5,7,12,,,,
16359,3,2,5,,,,
13955,3,0,3,,,,
17560,8,0,8,,,,
15955,1,4,5,,,,
9534,8,0,8,,,,
10366,11,5,16,,,,
13667,4,2,6,,,,
11142,12,9,21,,,,
5001,2,4,6,,,,
12616,5,38,43,,,,
3136,24,26,50,,,,
3926,13,65,78,,,,
1312,16,5,21,,,,
15133,15,10,25,,,,
4943,37,38,75,,,,
692,10,134,144,,,,
10673,2,7,9,,,,
8599,6,13,19,,,,
3043,35,14,49,,,,
17080,1,3,4,,,,
12712,2,29,31,,,,
3195,52,17,69,,,,
3348,11,4,15,,,,
14957,9,10,19,,,,
135,68,177,245,,,,
3669,11,5,16,,,,
12047,9,8,17,,,,
1897,118,4,122,,,,
4307,66,33,99,,,,
11888,5,10,15,,,,
8237,18,18,36,,,,
462,21,2,23,,,,
8058,19,8,27,,,,
14787,5,25,30,,,,
9999,2,2,4,,,,
1575,42,36,78,,,,
16018,16,23,39,,,,
785,11,27,38,,,,
82,23,137,160,,,,
13494,3,3,6,,,,
3753,9,16,25,,,,
7135,23,16,39,,,,
7251,1,9,10,,,,
13766,4,60,64,,,,
14947,3,11,14,,,,
3102,14,10,24,,,,
2683,48,18,66,,,,
12808,2,29,31,,,,
2746,4,12,16,,,,
15619,12,2,14,,,,
1993,84,161,245,,,,
5869,5,3,8,,,,
14784,5,2,7,,,,
7172,7,16,23,,,,
4627,8,14,22,,,,
8718,4,1,5,,,,
5272,16,2,18,,,,
13755,27,0,27,,,,
17685,7,3,10,,,,
8046,35,7,42,,,,
7702,12,11,23,,,,
12186,2,7,9,,,,
2327,131,40,171,,,,
270,7,3,10,,,,
852,12,43,55,,,,
10779,3,4,7,,,,
5470,89,107,196,,,,
9422,8,4,12,,,,
8532,18,73,91,,,,
1579,22,52,74,,,,
8970,27,1,28,,,,
11802,11,0,11,,,,
6245,11,21,32,,,,
2312,131,10,141,,,,
14677,7,2,9,,,,
13024,20,1,21,,,,
11640,8,2,10,,,,
2301,12,48,60,,,,
10163,7,6,13,,,,
7972,7,3,10,,,,
6237,30,25,55,,,,
10124,2,0,2,,,,
11847,12,4,16,,,,
3265,28,73,101,,,,
9349,41,4,45,,,,
6935,6,4,10,,,,
9886,12,7,19,,,,
2871,11,48,59,,,,
16389,6,2,8,,,,
5541,5,7,12,,,,
12003,59,52,111,,,,
15575,15,5,20,,,,
1011,12,5,17,,,,
13233,16,2,18,,,,
15105,4,1,5,,,,
15286,4,3,7,,,,
15201,1,1,2,,,,
5235,10,43,53,,,,
10306,2,5,7,,,,
13236,46,12,58,,,,
11898,3,2,5,,,,
15809,1,4,5,,,,
16085,34,9,43,,,,
14084,8,0,8,,,,
823,12,21,33,,,,
12096,7,12,19,,,,
17232,3,3,6,,,,
2224,3,5,8,,,,
12305,23,4,27,,,,
261,3,4,7,,,,
641,17,14,31,,,,
1279,3,13,16,,,,
7575,1,0,1,,,,
16862,1,4,5,,,,
14153,6,0,6,,,,
13115,9,20,29,,,,
951,8,2,10,,,,
1525,15,19,34,,,,
12980,15,13,28,,,,
10621,1,3,4,,,,
2002,15,6,21,,,,
5764,2,1,3,,,,
2245,8,6,14,,,,
5018,17,97,114,,,,
1798,1,2,3,,,,
2900,9,13,22,,,,
16813,4,4,8,,,,
2715,1,1,2,,,,
16882,5,2,7,,,,
10666,6,0,6,,,,
14376,3,0,3,,,,
9445,15,14,29,,,,
8226,39,4,43,,,,
9331,37,39,76,,,,
2397,8,64,72,,,,
323,1,4,5,,,,
13584,6,1,7,,,,
12824,30,5,35,,,,
10632,36,19,55,,,,
17276,11,3,14,,,,
7777,11,4,15,,,,
14025,3,3,6,,,,
10463,6,5,11,,,,
5813,2,9,11,,,,
16078,10,22,32,,,,
8290,36,25,61,,,,
17647,6,8,14,,,,
11356,6,0,6,,,,
14332,3,3,6,,,,
5694,16,1,17,,,,
8728,9,4,13,,,,
3800,2,5,7,,,,
8174,29,19,48,,,,
15781,24,5,29,,,,
7329,2,0,2,,,,
8312,12,7,19,,,,
12736,2,7,9,,,,
17509,4,1,5,,,,
4677,38,26,64,,,,
16202,17,7,24,,,,
14718,13,12,25,,,,
3864,24,10,34,,,,
1337,4,25,29,,,,
6883,4,5,9,,,,
9505,8,8,16,,,,
7362,22,9,31,,,,
3068,7,20,27,,,,
5787,2,7,9,,,,
6402,4,46,50,,,,
3889,16,59,75,,,,
3843,6,5,11,,,,
12721,10,0,10,,,,
11588,11,86,97,,,,
9673,13,18,31,,,,
14836,1,24,25,,,,
17883,1,0,1,,,,
1658,17,9,26,,,,
442,1,7,8,,,,
14285,6,27,33,,,,
10114,3,12,15,,,,
9047,3,1,4,,,,
14312,5,1,6,,,,
3518,3,2,5,,,,
5693,2,3,5,,,,
472,1,1,2,,,,
3134,9,0,9,,,,
9390,3,1,4,,,,
9605,8,8,16,,,,
5381,54,127,181,,,,
15544,2,5,7,,,,
5744,23,13,36,,,,
6421,83,41,124,,,,
8946,7,15,22,,,,
15903,13,6,19,,,,
14497,9,16,25,,,,
3050,1,6,7,,,,
85,53,28,81,,,,
3121,6,9,15,,,,
9653,7,7,14,,,,
313,2,29,31,,,,
5512,129,73,202,,,,
14672,2,63,65,,,,
17611,5,12,17,,,,
4015,2,8,10,,,,
1375,43,20,63,,,,
7896,1,6,7,,,,
9549,78,8,86,,,,
16624,12,7,19,,,,
6187,41,87,128,,,,
3500,6,13,19,,,,
749,147,21,168,,,,
1276,3,10,13,,,,
12452,2,76,78,,,,
563,71,18,89,,,,
3680,7,10,17,,,,
15904,3,17,20,,,,
2640,60,6,66,,,,
16838,8,56,64,,,,
11517,44,1,45,,,,
10418,20,1,21,,,,
4306,21,42,63,,,,
2277,11,15,26,,,,
15832,10,8,18,,,,
2628,74,66,140,,,,
15672,3,1,4,,,,
8414,9,8,17,,,,
453,13,1,14,,,,
16377,15,5,20,,,,
4309,32,29,61,,,,
9035,4,1,5,,,,
12763,2,5,7,,,,
5114,10,5,15,,,,
10806,10,8,18,,,,
14071,6,16,22,,,,
13632,3,1,4,,,,
7946,2,1,3,,,,
13411,5,20,25,,,,
4279,127,44,171,,,,
11952,10,5,15,,,,
9825,3,3,6,,,,
505,6,1,7,,,,
9372,1,8,9,,,,
12051,5,14,19,,,,
16889,4,17,21,,,,
2411,6,12,18,,,,
6969,6,12,18,,,,
904,131,3,134,,,,
12025,9,6,15,,,,
5538,11,34,45,,,,
11409,8,4,12,,,,
1200,8,0,8,,,,
16098,16,0,16,,,,
9823,4,2,6,,,,
9606,4,30,34,,,,
6641,14,18,32,,,,
16968,2,1,3,,,,
17845,13,3,16,,,,
4877,2,1,3,,,,
7498,4,17,21,,,,
15279,1,3,4,,,,
807,26,37,63,,,,
10048,22,38,60,,,,
15011,13,13,26,,,,
8004,7,23,30,,,,
16873,1,6,7,,,,
17171,3,4,7,,,,
1193,107,72,179,,,,
16032,40,0,40,,,,
12796,40,2,42,,,,
17161,6,5,11,,,,
7465,1,4,5,,,,
7210,4,5,9,,,,
4007,7,16,23,,,,
7723,9,31,40,,,,
6412,5,11,16,,,,
5847,14,57,71,,,,
8447,24,11,35,,,,
12086,12,4,16,,,,
2259,7,0,7,,,,
9543,2,2,4,,,,
6480,3,6,9,,,,
14030,13,5,18,,,,
14823,7,2,9,,,,
12665,9,6,15,,,,
5110,2,15,17,,,,
12356,12,53,65,,,,
8950,7,2,9,,,,
10862,6,0,6,,,,
9328,12,15,27,,,,
973,4,12,16,,,,
11360,2,0,2,,,,
9167,1,9,10,,,,
13704,10,34,44,,,,
13685,5,0,5,,,,
12510,8,6,14,,,,
12894,21,6,27,,,,
14543,14,41,55,,,,
10927,5,4,9,,,,
8543,4,80,84,,,,
16701,8,10,18,,,,
11164,2,0,2,,,,
7192,16,19,35,,,,
11613,27,45,72,,,,
1061,9,10,19,,,,
13807,12,40,52,,,,
13851,3,6,9,,,,
11894,3,10,13,,,,
16630,1,3,4,,,,
3788,5,1,6,,,,
16973,5,9,14,,,,
13401,3,13,16,,,,
3834,6,1,7,,,,
1399,61,3,64,,,,
6629,3,2,5,,,,
415,6,4,10,,,,
3031,11,11,22,,,,
16886,6,0,6,,,,
9952,7,9,16,,,,
10135,1,5,6,,,,
16195,17,0,17,,,,
17614,4,8,12,,,,
14742,2,2,4,,,,
1441,1,4,5,,,,
14525,19,4,23,,,,
12500,64,30,94,,,,
2678,39,106,145,,,,
2123,6,0,6,,,,
8488,8,10,18,,,,
10330,8,9,17,,,,
4826,5,8,13,,,,
1201,13,20,33,,,,
416,10,12,22,,,,
5738,5,11,16,,,,
13904,1,0,1,,,,
7185,14,8,22,,,,
3708,16,26,42,,,,
14640,5,16,21,,,,
13866,14,0,14,,,,
4478,62,39,101,,,,
2634,11,103,114,,,,
17242,1,0,1,,,,
3444,11,9,20,,,,
11719,66,15,81,,,,
17673,1,3,4,,,,
93,60,53,113,,,,
5061,3,27,30,,,,
3173,5,2,7,,,,
14634,14,15,29,,,,
15456,6,0,6,,,,
2934,38,51,89,,,,
4668,8,32,40,,,,
11664,12,29,41,,,,
4873,11,2,13,,,,
1718,105,136,241,,,,
9201,5,1,6,,,,
3992,23,8,31,,,,
4603,64,10,74,,,,
14342,10,2,12,,,,
134,43,6,49,,,,
14979,7,13,20,,,,
1468,1,24,25,,,,
3439,3,2,5,,,,
16803,6,4,10,,,,
13858,1,22,23,,,,
5811,10,17,27,,,,
15659,3,5,8,,,,
17354,2,3,5,,,,
11023,1,7,8,,,,
2256,4,2,6,,,,
4487,4,1,5,,,,
14046,4,7,11,,,,
16708,5,2,7,,,,
11845,3,10,13,,,,
13388,9,8,17,,,,
780,10,47,57,,,,
15730,2,3,5,,,,
10647,26,8,34,,,,
6510,2,0,2,,,,
11047,2,2,4,,,,
7953,39,5,44,,,,
8296,20,34,54,,,,
14964,13,3,16,,,,
13337,9,8,17,,,,
11936,5,5,10,,,,
2482,12,13,25,,,,
1124,4,2,6,,,,
7819,7,12,19,,,,
1592,6,2,8,,,,
5958,3,3,6,,,,
13139,23,5,28,,,,
2653,37,24,61,,,,
8679,3,1,4,,,,
1370,56,2,58,,,,
6687,5,4,9,,,,
7939,1,1,2,,,,
5519,129,78,207,,,,
14496,53,10,63,,,,
10825,9,0,9,,,,
7150,10,39,49,,,,
213,1,4,5,,,,
3955,4,13,17,,,,
16017,32,15,47,,,,
2829,28,9,37,,,,
7668,4,12,16,,,,
12453,5,27,32,,,,
9964,7,21,28,,,,
8619,5,6,11,,,,
8709,2,2,4,,,,
5900,5,4,9,,,,
17203,3,2,5,,,,
14905,25,10,35,,,,
11462,3,4,7,,,,
7551,4,19,23,,,,
8044,1,8,9,,,,
14656,13,12,25,,,,
9032,1,20,21,,,,
1678,24,25,49,,,,
9352,7,7,14,,,,
9934,14,13,27,,,,
3607,7,9,16,,,,
3508,2,13,15,,,,
6190,10,20,30,,,,
1975,69,42,111,,,,
11658,32,6,38,,,,
13830,2,0,2,,,,
2171,6,0,6,,,,
6291,19,20,39,,,,
10613,20,78,98,,,,
10406,3,0,3,,,,
11868,20,24,44,,,,
11087,19,7,26,,,,
6870,21,15,36,,,,
11061,7,2,9,,,,
6967,3,2,5,,,,
6731,1,3,4,,,,
1015,34,12,46,,,,
15482,7,3,10,,,,
12464,15,11,26,,,,
9472,16,2,18,,,,
6819,4,0,4,,,,
17107,1,3,4,,,,
3731,72,5,77,,,,
7028,2,3,5,,,,
7095,4,44,48,,,,
14994,4,0,4,,,,
16739,7,12,19,,,,
17828,10,2,12,,,,
15395,25,19,44,,,,
15741,2,1,3,,,,
3055,10,25,35,,,,
2018,9,9,18,,,,
285,27,132,159,,,,
1789,65,41,106,,,,
12553,2,0,2,,,,
5995,26,8,34,,,,
15340,3,9,12,,,,
12079,22,3,25,,,,
15276,15,6,21,,,,
6950,5,1,6,,,,
10526,65,25,90,,,,
3808,18,9,27,,,,
1803,3,20,23,,,,
2869,3,12,15,,,,
2063,24,22,46,,,,
4291,3,60,63,,,,
17144,2,7,9,,,,
6303,14,3,17,,,,
1489,3,1,4,,,,
13808,12,3,15,,,,
4863,9,2,11,,,,
14682,11,11,22,,,,
11594,10,2,12,,,,
14185,41,36,77,,,,
12140,12,20,32,,,,
16691,6,6,12,,,,
12053,17,3,20,,,,
11187,17,5,22,,,,
9598,9,13,22,,,,
7598,11,8,19,,,,
8738,5,17,22,,,,
5975,26,9,35,,,,
3802,1,1,2,,,,
16529,10,6,16,,,,
11143,6,2,8,,,,
5814,3,1,4,,,,
1084,11,0,11,,,,
9305,8,11,19,,,,
8354,22,5,27,,,,
10057,8,21,29,,,,
583,1,0,1,,,,
1153,42,13,55,,,,
2828,77,42,119,,,,
7774,7,4,11,,,,
5209,1,55,56,,,,
7281,43,1,44,,,,
7716,2,3,5,,,,
12734,10,1,11,,,,
5106,5,0,5,,,,
13277,3,2,5,,,,
12965,22,11,33,,,,
8968,21,26,47,,,,
17384,9,5,14,,,,
16515,1,9,10,,,,
14240,7,0,7,,,,
6915,8,3,11,,,,
6170,63,25,88,,,,
11708,6,37,43,,,,
7672,17,6,23,,,,
11829,13,31,44,,,,
8286,10,12,22,,,,
9685,10,6,16,,,,
12797,53,1,54,,,,
4948,5,2,7,,,,
9069,1,7,8,,,,
9595,24,12,36,,,,
1782,5,18,23,,,,
17115,9,2,11,,,,
9553,16,2,18,,,,
14975,8,10,18,,,,
4680,5,28,33,,,,
7902,14,22,36,,,,
10869,1,0,1,,,,
8268,50,31,81,,,,
15474,10,31,41,,,,
5443,53,81,134,,,,
12761,10,3,13,,,,
9455,6,4,10,,,,
8458,6,0,6,,,,
1936,46,55,101,,,,
3127,6,26,32,,,,
12979,39,25,64,,,,
9157,3,2,5,,,,
13149,9,13,22,,,,
15360,13,11,24,,,,
3486,23,5,28,,,,
11425,2,6,8,,,,
9416,11,0,11,,,,
4209,11,30,41,,,,
7571,9,3,12,,,,
11281,7,2,9,,,,
2553,31,10,41,,,,
6025,19,26,45,,,,
3796,3,27,30,,,,
1866,4,4,8,,,,
5222,2,10,12,,,,
6934,13,5,18,,,,
3223,10,31,41,,,,
10225,59,27,86,,,,
10717,22,5,27,,,,
4918,16,0,16,,,,
1049,5,10,15,,,,
17051,4,21,25,,,,
157,202,118,320,,,,
2241,3,12,15,,,,
7677,4,1,5,,,,
14173,20,32,52,,,,
604,23,4,27,,,,
5293,32,69,101,,,,
14513,4,7,11,,,,
11004,3,1,4,,,,
9389,1,2,3,,,,
111,155,27,182,,,,
1770,90,31,121,,,,
1519,7,14,21,,,,
8461,10,0,10,,,,
8129,19,32,51,,,,
15559,3,12,15,,,,
2457,44,0,44,,,,
13918,7,2,9,,,,
6617,20,97,117,,,,
3502,9,0,9,,,,
4195,7,29,36,,,,
5415,114,67,181,,,,
3077,111,8,119,,,,
2257,1,7,8,,,,
11266,2,5,7,,,,
8205,7,35,42,,,,
2631,38,7,45,,,,
12128,14,7,21,,,,
2392,104,24,128,,,,
12224,3,2,5,,,,
15441,9,1,10,,,,
2515,52,15,67,,,,
3689,3,72,75,,,,
17542,4,4,8,,,,
8899,20,6,26,,,,
16036,4,17,21,,,,
3477,2,14,16,,,,
5990,27,32,59,,,,
13724,8,47,55,,,,
13141,5,14,19,,,,
5677,1,5,6,,,,
8891,12,13,25,,,,
11062,3,4,7,,,,
9993,2,21,23,,,,
17288,13,0,13,,,,
3988,36,4,40,,,,
8695,1,5,6,,,,
11244,57,17,74,,,,
13237,14,18,32,,,,
4975,6,2,8,,,,
11077,3,16,19,,,,
3766,46,18,64,,,,
17249,3,0,3,,,,
4169,7,4,11,,,,
4162,11,1,12,,,,
17736,14,8,22,,,,
17112,9,2,11,,,,
8123,2,2,4,,,,
6314,5,25,30,,,,
174,5,52,57,,,,
6778,39,34,73,,,,
8917,6,2,8,,,,
7871,9,13,22,,,,
3975,46,29,75,,,,
9314,1,25,26,,,,
7084,8,6,14,,,,
1999,10,0,10,,,,
5217,6,20,26,,,,
13025,32,3,35,,,,
6645,18,12,30,,,,
3674,2,5,7,,,,
14998,9,9,18,,,,
9243,5,4,9,,,,
7935,9,2,11,,,,
5868,16,12,28,,,,
2978,8,1,9,,,,
2107,1,0,1,,,,
2613,38,148,186,,,,
2210,34,25,59,,,,
433,2,18,20,,,,
1429,174,98,272,,,,
10627,15,9,24,,,,
5798,19,0,19,,,,
10174,3,1,4,,,,
11685,31,3,34,,,,
11029,14,18,32,,,,
11547,1,1,2,,,,
12391,3,26,29,,,,
10550,7,86,93,,,,
1054,11,15,26,,,,
9774,3,13,16,,,,
10548,24,39,63,,,,
1107,9,1,10,,,,
6601,6,14,20,,,,
12248,9,5,14,,,,
15766,6,6,12,,,,
10909,39,0,39,,,,
13448,2,1,3,,,,
6199,74,27,101,,,,
14505,12,3,15,,,,
17671,3,4,7,,,,
9441,7,4,11,,,,
9235,17,49,66,,,,
7985,5,17,22,,,,
5295,61,3,64,,,,
12798,1,2,3,,,,
8198,1,36,37,,,,
8191,5,32,37,,,,
10067,5,9,14,,,,
13552,9,1,10,,,,
596,85,23,108,,,,
2919,6,19,25,,,,
2682,58,22,80,,,,
3994,16,53,69,,,,
14895,4,8,12,,,,
2911,80,16,96,,,,
13555,5,31,36,,,,
16023,32,23,55,,,,
14336,10,4,14,,,,
4406,25,5,30,,,,
17782,1,1,2,,,,
2249,1,2,3,,,,
7445,1,6,7,,,,
11046,6,4,10,,,,
493,58,19,77,,,,
78,30,158,188,,,,
9857,101,65,166,,,,
6633,31,30,61,,,,
73,71,17,88,,,,
11327,10,171,181,,,,
10994,6,6,12,,,,
6559,10,12,22,,,,
11271,20,27,47,,,,
1912,86,27,113,,,,
13447,16,6,22,,,,
14735,8,6,14,,,,
6743,2,92,94,,,,
2067,3,9,12,,,,
17465,4,5,9,,,,
14548,4,51,55,,,,
11550,1,0,1,,,,
10244,19,4,23,,,,
5916,3,3,6,,,,
4749,6,4,10,,,,
9869,1,35,36,,,,
10479,39,3,42,,,,
9822,2,7,9,,,,
3666,11,93,104,,,,
7644,9,3,12,,,,
12318,7,56,63,,,,
8289,13,34,47,,,,
3580,2,8,10,,,,
12806,1,1,2,,,,
15384,13,2,15,,,,
17379,3,3,6,,,,
3867,11,21,32,,,,
5570,16,44,60,,,,
11693,13,14,27,,,,
8575,2,5,7,,,,
2850,22,1,23,,,,
7759,7,0,7,,,,
2760,6,3,9,,,,
2508,2,13,15,,,,
8263,4,1,5,,,,
2623,91,94,185,,,,
2777,11,13,24,,,,
1231,106,38,144,,,,
6422,59,95,154,,,,
5487,19,9,28,,,,
7480,4,8,12,,,,
15761,3,19,22,,,,
4737,7,50,57,,,,
4998,3,12,15,,,,
17212,3,0,3,,,,
17819,2,2,4,,,,
9004,106,70,176,,,,
1334,25,23,48,,,,
2876,37,4,41,,,,
286,6,7,13,,,,
11577,6,8,14,,,,
7027,3,0,3,,,,
14951,3,39,42,,,,
10501,54,25,79,,,,
7115,49,12,61,,,,
3016,6,2,8,,,,
1795,140,65,205,,,,
1882,8,20,28,,,,
8593,8,5,13,,,,
16668,1,0,1,,,,
16080,13,5,18,,,,
9027,30,5,35,,,,
15251,6,6,12,,,,
13173,25,22,47,,,,
8082,91,33,124,,,,
12309,27,14,41,,,,
5307,13,6,19,,,,
3608,14,7,21,,,,
2081,4,31,35,,,,
7834,4,1,5,,,,
17066,3,41,44,,,,
3346,14,10,24,,,,
14729,26,9,35,,,,
13234,11,13,24,,,,
855,4,13,17,,,,
3445,10,1,11,,,,
3546,68,9,77,,,,
7390,3,7,10,,,,
14360,15,14,29,,,,
690,11,31,42,,,,
10392,2,2,4,,,,
16583,1,0,1,,,,
13775,2,4,6,,,,
15861,5,7,12,,,,
9492,7,0,7,,,,
13641,4,7,11,,,,
1644,10,182,192,,,,
8430,10,22,32,,,,
11268,66,13,79,,,,
2709,12,20,32,,,,
11663,35,1,36,,,,
7923,45,8,53,,,,
6183,8,31,39,,,,
6443,3,7,10,,,,
10954,6,2,8,,,,
4624,2,48,50,,,,
8587,10,41,51,,,,
4111,27,1,28,,,,
15523,9,8,17,,,,
1617,363,3,366,,,,
2151,1,6,7,,,,
216,15,14,29,,,,
8169,86,28,114,,,,
13820,15,2,17,,,,
17052,1,13,14,,,,
3355,7,22,29,,,,
9834,3,6,9,,,,
14228,15,0,15,,,,
12634,3,1,4,,,,
13974,5,0,5,,,,
14432,1,36,37,,,,
2005,38,2,40,,,,
13777,2,8,10,,,,
11512,15,1,16,,,,
734,147,15,162,,,,
6526,4,9,13,,,,
14575,12,25,37,,,,
11885,4,15,19,,,,
8231,11,58,69,,,,
10659,24,16,40,,,,
5652,17,31,48,,,,
4750,16,5,21,,,,
8614,21,20,41,,,,
8988,14,8,22,,,,
4903,9,1,10,,,,
98,17,16,33,,,,
6911,7,8,15,,,,
16586,3,1,4,,,,
3952,11,0,11,,,,
15214,6,0,6,,,,
11440,6,0,6,,,,
3459,2,0,2,,,,
114,41,35,76,,,,
10541,12,27,39,,,,
11679,33,13,46,,,,
17389,7,11,18,,,,
10969,13,18,31,,,,
11696,24,6,30,,,,
7661,11,17,28,,,,
11677,24,20,44,,,,
8741,26,23,49,,,,
13199,3,51,54,,,,
10105,2,3,5,,,,
6270,52,21,73,,,,
6276,1,2,3,,,,
16729,9,10,19,,,,
17670,3,1,4,,,,
7783,11,0,11,,,,
13523,34,1,35,,,,
2431,17,117,134,,,,
10681,4,4,8,,,,
7494,2,1,3,,,,
1612,61,30,91,,,,
17875,2,1,3,,,,
6718,6,4,10,,,,
13019,4,2,6,,,,
7489,18,1,19,,,,
1347,18,13,31,,,,
9744,1,3,4,,,,
16857,10,18,28,,,,
9963,21,1,22,,,,
6990,4,1,5,,,,
7014,6,23,29,,,,
8396,7,0,7,,,,
11415,10,2,12,,,,
16572,5,0,5,,,,
11699,81,0,81,,,,
15008,1,0,1,,,,
2122,3,0,3,,,,
8737,8,3,11,,,,
2128,2,6,8,,,,
3963,80,18,98,,,,
12430,30,47,77,,,,
9541,9,3,12,,,,
14864,4,2,6,,,,
3760,1,4,5,,,,
7062,9,0,9,,,,
15580,11,2,13,,,,
2575,5,7,12,,,,
8790,27,54,81,,,,
1820,78,36,114,,,,
7749,9,37,46,,,,
4780,1,11,12,,,,
2389,28,24,52,,,,
7164,2,4,6,,,,
7085,4,5,9,,,,
16299,1,23,24,,,,
1968,25,0,25,,,,
2713,72,56,128,,,,
11694,44,12,56,,,,
8308,16,5,21,,,,
6425,96,23,119,,,,
17843,11,4,15,,,,
11874,7,7,14,,,,
1394,159,82,241,,,,
9127,4,13,17,,,,
5543,28,72,100,,,,
1616,59,68,127,,,,
14,2,8,10,,,,
16719,5,1,6,,,,
13657,2,8,10,,,,
16005,35,9,44,,,,
5344,111,76,187,,,,
4835,4,9,13,,,,
12803,14,36,50,,,,
11967,11,50,61,,,,
3851,2,74,76,,,,
10372,3,4,7,,,,
17280,3,3,6,,,,
17839,2,0,2,,,,
2148,36,5,41,,,,
9800,4,29,33,,,,
7024,4,1,5,,,,
13013,24,18,42,,,,
1487,8,17,25,,,,
1952,52,94,146,,,,
9132,2,15,17,,,,
6577,4,31,35,,,,
8208,14,12,26,,,,
7622,4,9,13,,,,
13129,1,13,14,,,,
5410,191,0,191,,,,
15051,7,16,23,,,,
8580,25,0,25,,,,
15253,9,3,12,,,,
7786,12,53,65,,,,
12686,24,4,28,,,,
8457,6,3,9,,,,
7053,11,5,16,,,,
11194,21,4,25,,,,
3625,5,4,9,,,,
2722,23,18,41,,,,
3367,1,48,49,,,,
8630,12,18,30,,,,
17905,2,0,2,,,,
16024,12,50,62,,,,
6396,1,0,1,,,,
12565,7,2,9,,,,
16609,6,8,14,,,,
10561,5,4,9,,,,
9029,12,17,29,,,,
6570,5,16,21,,,,
6298,10,4,14,,,,
10087,9,21,30,,,,
17278,35,6,41,,,,
10834,5,4,9,,,,
3687,20,7,27,,,,
7810,17,1,18,,,,
5849,9,4,13,,,,
12000,18,33,51,,,,
1653,1,11,12,,,,
1862,42,51,93,,,,
3877,4,46,50,,,,
8485,7,1,8,,,,
205,59,5,64,,,,
14660,27,18,45,,,,
816,40,8,48,,,,
13076,12,8,20,,,,
7083,4,115,119,,,,
11068,11,8,19,,,,
14977,47,4,51,,,,
15374,5,0,5,,,,
1919,36,37,73,,,,
4854,3,7,10,,,,
8382,13,7,20,,,,
9060,23,1,24,,,,
11742,36,25,61,,,,
14841,3,10,13,,,,
4682,3,10,13,,,,
1437,5,6,11,,,,
4989,12,3,15,,,,
14904,21,0,21,,,,
7967,3,0,3,,,,
14265,12,7,19,,,,
2197,22,2,24,,,,
16077,14,10,24,,,,
13506,9,4,13,,,,
11173,3,6,9,,,,
17236,1,1,2,,,,
14802,8,2,10,,,,
15879,3,4,7,,,,
2559,8,7,15,,,,
126,9,8,17,,,,
12288,19,8,27,,,,
7649,12,4,16,,,,
4858,18,9,27,,,,
6908,23,8,31,,,,
17023,2,2,4,,,,
17020,2,1,3,,,,
11339,124,48,172,,,,
2475,4,15,19,,,,
15296,10,1,11,,,,
13935,8,8,16,,,,
16334,5,2,7,,,,
13958,15,3,18,,,,
13569,14,7,21,,,,
5141,14,0,14,,,,
13439,10,3,13,,,,
2169,3,0,3,,,,
6983,1,4,5,,,,
5147,16,54,70,,,,
10558,18,51,69,,,,
10993,13,13,26,,,,
9828,2,0,2,,,,
4914,2,7,9,,,,
8657,6,0,6,,,,
5908,3,25,28,,,,
11073,58,53,111,,,,
14298,11,11,22,,,,
3795,4,9,13,,,,
9503,1,1,2,,,,
1819,19,30,49,,,,
13091,2,15,17,,,,
1100,19,0,19,,,,
15872,3,3,6,,,,
5366,51,137,188,,,,
5258,5,12,17,,,,
1442,7,0,7,,,,
5020,54,2,56,,,,
6501,25,179,204,,,,
430,2,11,13,,,,
5277,17,0,17,,,,
2321,10,4,14,,,,
14740,2,2,4,,,,
7527,53,61,114,,,,
291,9,24,33,,,,
14796,9,2,11,,,,
1037,24,7,31,,,,
3198,10,0,10,,,,
12854,7,73,80,,,,
16652,2,5,7,,,,
10829,30,13,43,,,,
6082,7,16,23,,,,
12354,13,3,16,,,,
2607,1,81,82,,,,
161,58,130,188,,,,
7797,34,7,41,,,,
12842,2,0,2,,,,
7234,15,19,34,,,,
5720,34,16,50,,,,
3213,202,196,398,,,,
6816,22,21,43,,,,
16946,2,0,2,,,,
16521,2,16,18,,,,
6562,18,5,23,,,,
3455,3,9,12,,,,
4592,2,5,7,,,,
15964,8,2,10,,,,
7715,5,9,14,,,,
7965,9,6,15,,,,
5569,16,2,18,,,,
10439,5,1,6,,,,
1376,59,43,102,,,,
3728,31,18,49,,,,
15074,5,4,9,,,,
3713,7,20,27,,,,
2555,12,8,20,,,,
1654,97,40,137,,,,
6344,15,0,15,,,,
4411,7,8,15,,,,
1748,46,17,63,,,,
7346,3,4,7,,,,
15589,8,14,22,,,,
15295,26,7,33,,,,
11622,10,1,11,,,,
8763,1,0,1,,,,
5162,6,0,6,,,,
10229,35,11,46,,,,
12416,9,17,26,,,,
7951,29,1,30,,,,
3226,1,36,37,,,,
12208,3,2,5,,,,
4325,1,7,8,,,,
7887,31,3,34,,,,
4804,13,34,47,,,,
8949,7,2,9,,,,
593,5,5,10,,,,
4713,13,59,72,,,,
5628,22,3,25,,,,
15662,5,4,9,,,,
13613,1,5,6,,,,
853,74,12,86,,,,
3340,4,1,5,,,,
832,59,4,63,,,,
4155,1,4,5,,,,
7921,11,8,19,,,,
16537,2,1,3,,,,
3841,4,1,5,,,,
10786,41,11,52,,,,
9070,13,6,19,,,,
7503,60,13,73,,,,
10035,20,11,31,,,,
508,8,7,15,,,,
13593,9,2,11,,,,
1987,65,149,214,,,,
8601,10,3,13,,,,
4229,24,4,28,,,,
7721,21,5,26,,,,
4459,5,9,14,,,,
10842,2,8,10,,,,
17517,7,8,15,,,,
9012,3,3,6,,,,
5998,4,4,8,,,,
3292,9,137,146,,,,
8759,1,3,4,,,,
2138,1,1,2,,,,
5334,30,5,35,,,,
3692,33,55,88,,,,
8776,2,32,34,,,,
13184,4,67,71,,,,
8256,1,27,28,,,,
14716,1,15,16,,,,
13570,11,0,11,,,,
894,34,4,38,,,,
11932,7,2,9,,,,
15325,4,2,6,,,,
15932,2,0,2,,,,
15019,4,5,9,,,,
16771,9,7,16,,,,
5225,9,20,29,,,,
5593,16,2,18,,,,
10713,2,0,2,,,,
3285,48,48,96,,,,
15551,7,3,10,,,,
14625,3,5,8,,,,
15942,2,1,3,,,,
10872,12,2,14,,,,
14619,47,6,53,,,,
12877,7,4,11,,,,
4524,40,3,43,,,,
1913,29,0,29,,,,
12132,1,5,6,,,,
12206,6,5,11,,,,
14455,12,10,22,,,,
7664,4,15,19,,,,
10176,37,3,40,,,,
6877,3,0,3,,,,
6140,12,12,24,,,,
1041,8,8,16,,,,
10013,3,5,8,,,,
461,3,6,9,,,,
7107,8,9,17,,,,
2728,5,36,41,,,,
16429,1,4,5,,,,
264,4,14,18,,,,
1690,347,30,377,,,,
6347,14,5,19,,,,
16610,2,1,3,,,,
7109,26,8,34,,,,
5149,24,16,40,,,,
10566,13,10,23,,,,
6557,2,1,3,,,,
2754,2,6,8,,,,
12544,59,11,70,,,,
3762,25,0,25,,,,
4312,21,143,164,,,,
10446,5,0,5,,,,
17822,1,0,1,,,,
3201,26,6,32,,,,
4108,5,21,26,,,,
9895,2,17,19,,,,
12384,1,4,5,,,,
1315,12,68,80,,,,
3614,8,31,39,,,,
14115,7,6,13,,,,
17702,1,1,2,,,,
3765,2,3,5,,,,
7438,1,0,1,,,,
8254,15,8,23,,,,
4442,12,19,31,,,,
5048,5,14,19,,,,
5614,67,3,70,,,,
9444,1,4,5,,,,
5241,18,2,20,,,,
15088,9,0,9,,,,
14184,7,30,37,,,,
2825,29,2,31,,,,
6668,14,26,40,,,,
94,17,49,66,,,,
5568,21,2,23,,,,
17009,1,2,3,,,,
12719,10,7,17,,,,
13085,68,18,86,,,,
8074,7,11,18,,,,
15189,8,8,16,,,,
12154,1,5,6,,,,
2551,4,1,5,,,,
9669,13,4,17,,,,
6242,18,61,79,,,,
16348,5,24,29,,,,
7720,45,106,151,,,,
6287,19,8,27,,,,
3985,4,0,4,,,,
14444,1,0,1,,,,
805,6,40,46,,,,
1723,15,296,311,,,,
14985,15,5,20,,,,
11259,8,2,10,,,,
11920,6,1,7,,,,
14481,6,5,11,,,,
7805,6,23,29,,,,
10686,14,11,25,,,,
7714,25,17,42,,,,
12478,10,41,51,,,,
11791,23,19,42,,,,
10528,21,20,41,,,,
760,92,47,139,,,,
11255,17,12,29,,,,
13189,1,9,10,,,,
9321,1,1,2,,,,
14727,14,62,76,,,,
5504,113,77,190,,,,
14728,6,13,19,,,,
1116,5,9,14,,,,
14362,4,10,14,,,,
7865,10,2,12,,,,
5851,2,55,57,,,,
11016,6,1,7,,,,
16852,6,0,6,,,,
7020,67,22,89,,,,
15655,23,10,33,,,,
14879,11,24,35,,,,
5315,15,0,15,,,,
17577,1,4,5,,,,
1641,82,118,200,,,,
1699,36,340,376,,,,
14733,1,3,4,,,,
1262,22,55,77,,,,
3288,14,22,36,,,,
14842,11,1,12,,,,
6958,3,63,66,,,,
3761,9,6,15,,,,
14433,5,3,8,,,,
4731,42,12,54,,,,
17646,2,1,3,,,,
13156,5,8,13,,,,
4024,15,9,24,,,,
8076,6,6,12,,,,
15939,11,1,12,,,,
210,4,20,24,,,,
3583,2,2,4,,,,
9139,8,0,8,,,,
16669,12,6,18,,,,
10169,1,16,17,,,,
3142,22,234,256,,,,
483,23,5,28,,,,
2480,5,5,10,,,,
12369,10,13,23,,,,
14253,3,1,4,,,,
2984,4,1,5,,,,
16362,1,0,1,,,,
6740,24,71,95,,,,
5324,21,28,49,,,,
14245,3,7,10,,,,
11106,1,14,15,,,,
6378,2,25,27,,,,
6308,5,0,5,,,,
3397,1,3,4,,,,
3506,2,4,6,,,,
15935,8,6,14,,,,
199,38,83,121,,,,
8061,10,9,19,,,,
17254,2,11,13,,,,
10504,31,9,40,,,,
5631,9,13,22,,,,
15402,23,1,24,,,,
12466,27,21,48,,,,
10545,4,4,8,,,,
15045,3,4,7,,,,
4165,10,81,91,,,,
2150,10,6,16,,,,
974,10,31,41,,,,
5039,6,4,10,,,,
15631,2,26,28,,,,
2858,12,4,16,,,,
13004,72,19,91,,,,
16232,3,11,14,,,,
1367,86,8,94,,,,
12239,4,10,14,,,,
3475,2,5,7,,,,
14401,2,1,3,,,,
633,38,31,69,,,,
15937,3,9,12,,,,
1150,7,23,30,,,,
14222,7,6,13,,,,
7879,24,67,91,,,,
1466,19,8,27,,,,
14368,26,8,34,,,,
3152,2,0,2,,,,
9782,6,11,17,,,,
6551,22,6,28,,,,
9753,34,17,51,,,,
13052,9,15,24,,,,
12836,3,8,11,,,,
17184,6,6,12,,,,
4953,2,1,3,,,,
628,4,6,10,,,,
8266,34,0,34,,,,
6574,4,20,24,,,,
6061,8,10,18,,,,
5441,63,26,89,,,,
7304,1,7,8,,,,
11149,1,0,1,,,,
3858,35,29,64,,,,
1204,4,5,9,,,,
11276,3,2,5,,,,
13530,12,7,19,,,,
5842,19,9,28,,,,
5877,4,7,11,,,,
13951,17,14,31,,,,
185,5,8,13,,,,
8388,9,11,20,,,,
11457,4,0,4,,,,
14913,2,14,16,,,,
5458,39,63,102,,,,
4380,1,0,1,,,,
9297,1,0,1,,,,
8398,8,16,24,,,,
6474,9,19,28,,,,
15681,5,4,9,,,,
12990,2,17,19,,,,
506,1,25,26,,,,
10617,16,6,22,,,,
9371,5,3,8,,,,
9477,6,9,15,,,,
11784,13,3,16,,,,
8249,7,12,19,,,,
11734,34,22,56,,,,
2429,105,1,106,,,,
7848,28,7,35,,,,
10751,4,6,10,,,,
2886,13,13,26,,,,
13162,3,5,8,,,,
4141,4,3,7,,,,
4920,1,1,2,,,,
5502,185,27,212,,,,
6762,12,2,14,,,,
964,4,0,4,,,,
5891,3,31,34,,,,
8616,2,23,25,,,,
1890,16,81,97,,,,
10015,11,20,31,,,,
13110,46,11,57,,,,
3093,7,8,15,,,,
17682,3,6,9,,,,
10715,7,2,9,,,,
4846,11,41,52,,,,
3480,61,22,83,,,,
5516,64,111,175,,,,
11084,4,26,30,,,,
9941,9,1,10,,,,
1596,76,189,265,,,,
3685,11,15,26,,,,
17110,6,5,11,,,,
14968,39,6,45,,,,
15150,6,6,12,,,,
7631,8,31,39,,,,
10819,16,1,17,,,,
10800,11,4,15,,,,
15483,1,1,2,,,,
9758,26,9,35,,,,
12402,5,5,10,,,,
6866,1,4,5,,,,
6415,24,55,79,,,,
4130,6,7,13,,,,
4148,33,18,51,,,,
8055,5,1,6,,,,
11751,3,5,8,,,,
664,23,109,132,,,,
5993,11,31,42,,,,
16321,12,13,25,,,,
9793,18,0,18,,,,
4744,8,21,29,,,,
2396,91,95,186,,,,
116,111,93,204,,,,
10725,1,3,4,,,,
9119,11,3,14,,,,
12266,2,7,9,,,,
7232,38,17,55,,,,
4071,29,56,85,,,,
4649,5,11,16,,,,
10797,1,20,21,,,,
14984,2,8,10,,,,
13627,4,12,16,,,,
3086,10,2,12,,,,
5714,3,2,5,,,,
7374,8,1,9,,,,
11017,7,3,10,,,,
8558,29,8,37,,,,
17029,4,6,10,,,,
1419,75,1,76,,,,
14529,12,5,17,,,,
16815,12,1,13,,,,
15533,4,1,5,,,,
10055,24,28,52,,,,
14955,11,10,21,,,,
17545,9,0,9,,,,
15355,1,2,3,,,,
2425,24,2,26,,,,
1747,24,110,134,,,,
3920,6,63,69,,,,
12156,1,0,1,,,,
7843,76,43,119,,,,
14986,2,5,7,,,,
8292,18,33,51,,,,
12513,42,33,75,,,,
15708,3,6,9,,,,
3830,4,5,9,,,,
15414,24,14,38,,,,
15015,2,23,25,,,,
13445,6,1,7,,,,
17330,5,6,11,,,,
17201,2,1,3,,,,
4796,6,22,28,,,,
17305,2,1,3,,,,
520,12,18,30,,,,
3196,11,0,11,,,,
439,16,6,22,,,,
9779,4,6,10,,,,
10826,33,12,45,,,,
687,38,18,56,,,,
4725,58,8,66,,,,
10968,5,0,5,,,,
7680,14,1,15,,,,
12164,1,0,1,,,,
6689,3,5,8,,,,
12517,9,2,11,,,,
13011,32,15,47,,,,
7220,208,208,416,,,,
15401,2,14,16,,,,
626,7,112,119,,,,
15236,1,9,10,,,,
6281,47,45,92,,,,
10999,1,8,9,,,,
16754,4,1,5,,,,
10596,3,4,7,,,,
7653,13,0,13,,,,
7206,10,50,60,,,,
2779,3,3,6,,,,
10111,5,5,10,,,,
14557,3,53,56,,,,
5949,24,5,29,,,,
11287,4,0,4,,,,
3339,36,7,43,,,,
10793,6,43,49,,,,
4350,1,1,2,,,,
6823,7,4,11,,,,
3233,2,7,9,,,,
5148,7,2,9,,,,
8047,3,25,28,,,,
6741,14,79,93,,,,
16155,1,13,14,,,,
11011,6,9,15,,,,
305,21,14,35,,,,
13778,14,9,23,,,,
13250,6,6,12,,,,
17498,2,0,2,,,,
10436,5,7,12,,,,
3827,2,4,6,,,,
13994,16,3,19,,,,
868,12,5,17,,,,
8301,1,27,28,,,,
4698,2,5,7,,,,
15999,25,23,48,,,,
14136,5,13,18,,,,
2686,10,5,15,,,,
6058,4,87,91,,,,
4904,24,13,37,,,,
512,26,2,28,,,,
1111,5,7,12,,,,
15328,2,0,2,,,,
11904,17,11,28,,,,
7906,2,28,30,,,,
10607,7,2,9,,,,
12301,6,11,17,,,,
16282,2,0,2,,,,
11458,17,42,59,,,,
5311,17,4,21,,,,
11135,2,20,22,,,,
5473,162,52,214,,,,
9087,2,2,4,,,,
5206,18,7,25,,,,
11190,4,21,25,,,,
6358,1,1,2,,,,
15349,15,7,22,,,,
17537,2,0,2,,,,
2915,72,11,83,,,,
3732,10,0,10,,,,
1134,10,18,28,,,,
3058,2,15,17,,,,
16448,3,15,18,,,,
9094,29,10,39,,,,
8253,17,5,22,,,,
6377,4,1,5,,,,
4003,23,5,28,,,,
4123,81,0,81,,,,
8088,1,1,2,,,,
11951,1,0,1,,,,
11817,11,6,17,,,,
16819,8,0,8,,,,
11773,14,35,49,,,,
2370,83,30,113,,,,
14908,9,18,27,,,,
6092,6,6,12,,,,
1701,28,17,45,,,,
11740,31,85,116,,,,
7213,9,14,23,,,,
1808,6,16,22,,,,
16918,5,1,6,,,,
17826,2,5,7,,,,
4954,2,4,6,,,,
4035,67,35,102,,,,
5634,7,2,9,,,,
69,26,42,68,,,,
11600,1,1,2,,,,
16600,1,4,5,,,,
8813,3,3,6,,,,
7770,4,1,5,,,,
11602,3,6,9,,,,
6893,12,10,22,,,,
5069,4,9,13,,,,
5972,1,2,3,,,,
11256,14,6,20,,,,
9723,17,25,42,,,,
13683,2,2,4,,,,
16751,5,6,11,,,,
12855,5,6,11,,,,
2495,41,15,56,,,,
9537,1,3,4,,,,
14777,8,0,8,,,,
336,7,7,14,,,,
2618,1,1,2,,,,
5878,25,26,51,,,,
14888,13,9,22,,,,
14695,13,11,24,,,,
6835,7,6,13,,,,
11335,167,7,174,,,,
5075,22,0,22,,,,
5180,1,2,3,,,,
5765,2,3,5,,,,
3561,12,2,14,,,,
17455,2,1,3,,,,
12355,28,20,48,,,,
10327,9,5,14,,,,
949,5,2,7,,,,
1524,13,3,16,,,,
8339,7,4,11,,,,
12538,93,17,110,,,,
11098,30,3,33,,,,
13047,1,7,8,,,,
10072,13,15,28,,,,
1079,23,2,25,,,,
16149,1,0,1,,,,
11598,3,6,9,,,,
11030,1,13,14,,,,
916,6,18,24,,,,
1643,39,92,131,,,,
7442,2,1,3,,,,
806,29,11,40,,,,
12134,11,11,22,,,,
13856,5,5,10,,,,
15145,9,1,10,,,,
14244,2,9,11,,,,
2246,43,78,121,,,,
10133,6,15,21,,,,
4116,16,5,21,,,,
17683,3,0,3,,,,
15862,1,2,3,,,,
5339,27,2,29,,,,
4192,6,8,14,,,,
3146,4,7,11,,,,
8126,16,5,21,,,,
11808,2,18,20,,,,
9926,8,4,12,,,,
11371,2,1,3,,,,
7999,10,19,29,,,,
15368,1,7,8,,,,
12819,5,24,29,,,,
13023,18,3,21,,,,
11686,26,37,63,,,,
5630,6,4,10,,,,
6492,112,2,114,,,,
14353,10,33,43,,,,
17090,10,1,11,,,,
14741,5,29,34,,,,
6202,3,21,24,,,,
752,7,8,15,,,,
5773,3,14,17,,,,
5221,1,36,37,,,,
8437,6,3,9,,,,
16215,1,1,2,,,,
13503,6,26,32,,,,
7430,17,4,21,,,,
754,14,33,47,,,,
14693,13,21,34,,,,
7317,2,1,3,,,,
5733,4,47,51,,,,
10524,44,8,52,,,,
8645,4,1,5,,,,
7003,12,32,44,,,,
3394,2,3,5,,,,
8837,2,3,5,,,,
1154,20,13,33,,,,
13911,3,9,12,,,,
13472,3,4,7,,,,
14325,11,6,17,,,,
233,7,30,37,,,,
8220,45,3,48,,,,
12521,5,1,6,,,,
5218,4,10,14,,,,
6696,5,3,8,,,,
4523,46,26,72,,,,
13346,28,9,37,,,,
7816,15,12,27,,,,
13874,6,2,8,,,,
3542,1,9,10,,,,
544,10,3,13,,,,
6345,2,13,15,,,,
1136,3,15,18,,,,
10357,3,1,4,,,,
15758,13,0,13,,,,
2602,120,58,178,,,,
2147,3,1,4,,,,
16369,1,0,1,,,,
4374,195,4,199,,,,
6111,17,12,29,,,,
1309,43,46,89,,,,
5673,1,5,6,,,,
13391,5,8,13,,,,
14684,2,12,14,,,,
14008,1,1,2,,,,
8196,28,12,40,,,,
11412,1,2,3,,,,
14229,1,3,4,,,,
8542,31,57,88,,,,
7893,38,12,50,,,,
10044,6,12,18,,,,
16965,1,0,1,,,,
11134,2,16,18,,,,
8560,15,20,35,,,,
10052,50,26,76,,,,
10943,6,2,8,,,,
9017,4,2,6,,,,
10314,14,42,56,,,,
17792,1,11,12,,,,
3178,42,21,63,,,,
5965,10,2,12,,,,
4451,4,0,4,,,,
5933,1,8,9,,,,
9581,36,1,37,,,,
10505,20,18,38,,,,
6984,5,8,13,,,,
6483,9,13,22,,,,
8028,4,7,11,,,,
12805,4,7,11,,,,
12087,4,3,7,,,,
7940,2,18,20,,,,
3560,3,4,7,,,,
16704,20,0,20,,,,
14664,11,23,34,,,,
16161,27,0,27,,,,
8223,4,45,49,,,,
10563,2,10,12,,,,
6939,11,6,17,,,,
3991,2,1,3,,,,
14928,11,0,11,,,,
3756,59,3,62,,,,
6810,29,0,29,,,,
15350,6,4,10,,,,
4818,15,19,34,,,,
17163,1,1,2,,,,
769,52,4,56,,,,
844,46,13,59,,,,
8569,4,41,45,,,,
1932,118,109,227,,,,
9587,9,11,20,,,,
6226,24,104,128,,,,
6309,4,10,14,,,,
8598,5,4,9,,,,
7214,41,7,48,,,,
8468,15,8,23,,,,
7479,6,12,18,,,,
10653,5,5,10,,,,
1719,49,126,175,,,,
13982,2,15,17,,,,
14868,2,5,7,,,,
2473,1,12,13,,,,
6189,3,29,32,,,,
12548,3,22,25,,,,
7470,2,11,13,,,,
12084,15,2,17,,,,
5669,69,14,83,,,,
13070,6,4,10,,,,
2309,73,29,102,,,,
11850,25,2,27,,,,
11317,1,1,2,,,,
1070,6,4,10,,,,
12788,1,3,4,,,,
2932,48,1,49,,,,
2703,36,17,53,,,,
10249,2,0,2,,,,
3341,19,4,23,,,,
6095,2,3,5,,,,
7734,9,10,19,,,,
16579,2,4,6,,,,
4787,35,27,62,,,,
1467,4,0,4,,,,
12947,3,5,8,,,,
10680,14,12,26,,,,
15181,7,0,7,,,,
9754,7,4,11,,,,
14139,9,2,11,,,,
11558,17,2,19,,,,
7514,2,30,32,,,,
2132,45,69,114,,,,
12926,5,9,14,,,,
12715,9,15,24,,,,
4625,10,23,33,,,,
781,8,3,11,,,,
1305,55,102,157,,,,
2155,8,7,15,,,,
16416,1,4,5,,,,
14006,1,0,1,,,,
10424,1,11,12,,,,
10215,10,10,20,,,,
660,41,252,293,,,,
5117,18,53,71,,,,
13542,8,11,19,,,,
4508,28,16,44,,,,
11428,14,1,15,,,,
16865,2,5,7,,,,
10141,9,2,11,,,,
13990,2,5,7,,,,
4085,3,1,4,,,,
3446,7,4,11,,,,
2837,9,15,24,,,,
3084,6,19,25,,,,
12539,13,13,26,,,,
13260,1,0,1,,,,
7402,3,6,9,,,,
5045,26,3,29,,,,
7308,8,0,8,,,,
9833,5,26,31,,,,
5050,21,11,32,,,,
8333,30,11,41,,,,
13817,3,2,5,,,,
679,20,69,89,,,,
12591,7,11,18,,,,
8476,23,5,28,,,,
15526,3,4,7,,,,
9400,1,24,25,,,,
10802,3,12,15,,,,
4969,16,5,21,,,,
6255,75,77,152,,,,
9333,21,0,21,,,,
7552,19,48,67,,,,
5340,1,54,55,,,,
6222,23,122,145,,,,
11691,11,18,29,,,,
13692,3,1,4,,,,
13615,4,17,21,,,,
2614,7,48,55,,,,
6493,1,7,8,,,,
7274,8,11,19,,,,
3199,41,34,75,,,,
12188,4,3,7,,,,
774,14,8,22,,,,
10316,3,2,5,,,,
8934,7,2,9,,,,
706,53,31,84,,,,
1339,77,0,77,,,,
16305,22,7,29,,,,
15618,2,0,2,,,,
14164,10,2,12,,,,
9250,5,8,13,,,,
195,66,42,108,,,,
13546,8,8,16,,,,
3122,3,0,3,,,,
4260,7,164,171,,,,
1659,20,91,111,,,,
924,72,2,74,,,,
2594,3,2,5,,,,
4935,61,29,90,,,,
7616,3,9,12,,,,
5013,2,2,4,,,,
3,4,2,6,,,,
4458,4,0,4,,,,
10278,1,3,4,,,,
11246,12,5,17,,,,
5796,2,3,5,,,,
1097,3,1,4,,,,
17019,2,1,3,,,,
9792,25,13,38,,,,
8800,14,6,20,,,,
12641,11,8,19,,,,
16079,37,4,41,,,,
5820,50,21,71,,,,
15657,28,1,29,,,,
53,16,5,21,,,,
6853,66,1,67,,,,
12967,11,15,26,,,,
16423,7,2,9,,,,
4443,20,0,20,,,,
6667,12,11,23,,,,
8672,5,1,6,,,,
1972,154,51,205,,,,
9942,4,7,11,,,,
12702,5,5,10,,,,
8132,3,83,86,,,,
8404,7,0,7,,,,
11608,12,8,20,,,,
1335,150,25,175,,,,
566,32,3,35,,,,
16487,1,1,2,,,,
13721,20,12,32,,,,
6340,32,43,75,,,,
4293,10,3,13,,,,
3899,2,7,9,,,,
9931,1,14,15,,,,
13695,7,14,21,,,,
7548,5,14,19,,,,
14874,5,7,12,,,,
7584,8,18,26,,,,
14126,4,3,7,,,,
4906,3,7,10,,,,
1896,10,25,35,,,,
1977,11,17,28,,,,
2926,33,65,98,,,,
13459,8,3,11,,,,
8961,2,3,5,,,,
3190,7,0,7,,,,
7941,34,5,39,,,,
13970,1,7,8,,,,
10583,2,7,9,,,,
1554,19,7,26,,,,
15301,5,12,17,,,,
9479,2,0,2,,,,
5510,74,61,135,,,,
9518,7,2,9,,,,
9994,10,10,20,,,,
13936,2,14,16,,,,
2143,10,8,18,,,,
10066,25,18,43,,,,
3007,7,22,29,,,,
11216,7,1,8,,,,
9187,5,10,15,,,,
7693,2,9,11,,,,
8095,1,2,3,,,,
2775,4,49,53,,,,
13954,1,8,9,,,,
4529,41,29,70,,,,
6793,24,29,53,,,,
7366,18,3,21,,,,
11201,10,7,17,,,,
3790,15,0,15,,,,
2969,30,18,48,,,,
3313,17,28,45,,,,
13963,12,2,14,,,,
17844,8,5,13,,,,
321,26,1,27,,,,
8549,4,3,7,,,,
1796,213,76,289,,,,
16676,1,1,2,,,,
1029,16,5,21,,,,
17365,8,1,9,,,,
11863,2,8,10,,,,
3303,45,0,45,,,,
13968,5,9,14,,,,
3309,118,10,128,,,,
11178,9,6,15,,,,
5594,6,0,6,,,,
8213,4,32,36,,,,
14093,45,8,53,,,,
14168,2,0,2,,,,
6738,2,15,17,,,,
6638,6,6,12,,,,
4059,14,83,97,,,,
5881,12,19,31,,,,
10373,29,7,36,,,,
8517,12,15,27,,,,
4449,3,0,3,,,,
7079,3,3,6,,,,
14201,24,26,50,,,,
12050,4,19,23,,,,
13507,19,7,26,,,,
11444,1,1,2,,,,
3200,2,38,40,,,,
8002,36,19,55,,,,
13207,9,46,55,,,,
10089,12,23,35,,,,
13310,16,0,16,,,,
13829,3,3,6,,,,
11669,72,8,80,,,,
11656,2,51,53,,,,
14070,9,11,20,,,,
16394,1,5,6,,,,
4421,5,23,28,,,,
1812,14,51,65,,,,
13563,12,16,28,,,,
4407,6,3,9,,,,
17351,1,9,10,,,,
3398,1,2,3,,,,
16657,3,2,5,,,,
13844,5,1,6,,,,
12585,6,4,10,,,,
6450,13,1,14,,,,
1685,29,69,98,,,,
12790,5,15,20,,,,
8170,31,59,90,,,,
881,13,0,13,,,,
8717,8,19,27,,,,
11269,15,83,98,,,,
3235,250,85,335,,,,
9228,2,0,2,,,,
8715,13,2,15,,,,
4527,7,9,16,,,,
6598,5,10,15,,,,
2492,2,17,19,,,,
9481,7,5,12,,,,
2353,5,21,26,,,,
8159,3,19,22,,,,
13163,5,2,7,,,,
2003,7,2,9,,,,
625,4,10,14,,,,
5511,183,11,194,,,,
14335,6,2,8,,,,
4757,71,25,96,,,,
3073,23,5,28,,,,
1512,9,12,21,,,,
9906,71,21,92,,,,
6014,4,0,4,,,,
8855,2,3,5,,,,
17415,5,7,12,,,,
14408,8,2,10,,,,
17757,7,1,8,,,,
3637,31,5,36,,,,
15598,16,8,24,,,,
6227,191,18,209,,,,
6259,28,134,162,,,,
7309,1,12,13,,,,
799,8,21,29,,,,
13747,9,1,10,,,,
7273,16,3,19,,,,
11377,12,13,25,,,,
4530,42,6,48,,,,
10600,4,1,5,,,,
6102,46,4,50,,,,
295,12,15,27,,,,
8843,4,2,6,,,,
4852,4,33,37,,,,
13217,4,20,24,,,,
1372,2,42,44,,,,
10414,1,3,4,,,,
932,31,25,56,,,,
639,19,93,112,,,,
10741,31,2,33,,,,
11391,11,5,16,,,,
2708,5,24,29,,,,
7385,23,3,26,,,,
9953,36,9,45,,,,
3284,30,105,135,,,,
8892,3,18,21,,,,
17125,5,16,21,,,,
11247,50,29,79,,,,
7573,24,5,29,,,,
5752,11,2,13,,,,
3017,10,17,27,,,,
1126,8,6,14,,,,
2331,17,64,81,,,,
3748,28,5,33,,,,
2402,15,9,24,,,,
16996,3,6,9,,,,
11226,2,4,6,,,,
528,16,104,120,,,,
9255,49,8,57,,,,
13002,4,0,4,,,,
6060,24,62,86,,,,
4069,22,8,30,,,,
14142,1,24,25,,,,
3844,13,0,13,,,,
16172,2,1,3,,,,
833,1,4,5,,,,
7908,5,14,19,,,,
16340,1,0,1,,,,
14089,3,4,7,,,,
15698,4,2,6,,,,
13548,1,13,14,,,,
10820,5,2,7,,,,
4224,25,38,63,,,,
15042,3,0,3,,,,
57,9,10,19,,,,
14032,25,0,25,,,,
1693,9,51,60,,,,
3578,15,2,17,,,,
2861,79,3,82,,,,
4492,44,9,53,,,,
10187,7,30,37,,,,
9268,3,20,23,,,,
1151,11,7,18,,,,
3657,5,17,22,,,,
17175,12,1,13,,,,
7290,10,13,23,,,,
13490,11,4,15,,,,
6153,30,29,59,,,,
17457,13,14,27,,,,
7733,2,8,10,,,,
5675,3,8,11,,,,
20,5,2,7,,,,
6591,11,24,35,,,,
12205,12,8,20,,,,
16807,4,7,11,,,,
797,93,12,105,,,,
17165,1,14,15,,,,
15427,3,12,15,,,,
12626,4,8,12,,,,
13427,12,1,13,,,,
10706,1,11,12,,,,
499,17,71,88,,,,
13007,60,38,98,,,,
7998,20,0,20,,,,
10490,1,22,23,,,,
6205,2,17,19,,,,
6933,20,19,39,,,,
14487,5,3,8,,,,
14700,12,12,24,,,,
11310,1,4,5,,,,
13474,11,11,22,,,,
9973,6,37,43,,,,
6121,67,19,86,,,,
1373,13,13,26,,,,
4673,13,32,45,,,,
1844,20,12,32,,,,
3249,60,9,69,,,,
5893,20,14,34,,,,
12881,3,1,4,,,,
2264,2,0,2,,,,
5184,17,3,20,,,,
4033,21,27,48,,,,
968,21,0,21,,,,
14331,2,22,24,,,,
6265,1,25,26,,,,
14838,6,19,25,,,,
17662,11,8,19,,,,
17809,1,0,1,,,,
6235,7,135,142,,,,
15449,31,15,46,,,,
12281,21,10,31,,,,
6708,3,1,4,,,,
11464,6,0,6,,,,
3721,59,50,109,,,,
15908,10,11,21,,,,
11948,21,12,33,,,,
13629,2,4,6,,,,
12093,28,19,47,,,,
14317,9,9,18,,,,
8947,12,8,20,,,,
4324,23,19,42,,,,
6592,7,31,38,,,,
740,119,30,149,,,,
7259,2,1,3,,,,
9709,3,19,22,,,,
8791,31,69,100,,,,
4760,32,5,37,,,,
1672,80,30,110,,,,
14373,7,7,14,,,,
22,21,6,27,,,,
17231,11,21,32,,,,
14196,9,28,37,,,,
25,12,22,34,,,,
2747,19,7,26,,,,
16713,2,0,2,,,,
5702,5,21,26,,,,
14594,10,3,13,,,,
12476,8,50,58,,,,
15917,1,9,10,,,,
9257,1,52,53,,,,
12004,85,121,206,,,,
5331,18,1,19,,,,
9546,40,24,64,,,,
9661,1,26,27,,,,
14988,2,8,10,,,,
12007,30,60,90,,,,
1790,11,53,64,,,,
8831,1,2,3,,,,
3942,43,33,76,,,,
13625,8,13,21,,,,
7636,22,3,25,,,,
497,4,7,11,,,,
10586,8,1,9,,,,
6296,71,69,140,,,,
6339,44,40,84,,,,
17718,7,0,7,,,,
14875,8,9,17,,,,
10515,10,18,28,,,,
15912,14,6,20,,,,
9418,6,3,9,,,,
10906,2,3,5,,,,
8579,6,5,11,,,,
14148,7,8,15,,,,
7852,7,4,11,,,,
17506,1,23,24,,,,
10269,2,1,3,,,,
2717,24,0,24,,,,
1689,126,77,203,,,,
5135,8,22,30,,,,
12933,1,10,11,,,,
12868,15,6,21,,,,
923,51,13,64,,,,
12401,3,0,3,,,,
5233,1,18,19,,,,
14236,3,2,5,,,,
10243,1,0,1,,,,
15387,37,12,49,,,,
10649,2,1,3,,,,
14552,2,1,3,,,,
12988,7,5,12,,,,
7907,7,3,10,,,,
16260,16,3,19,,,,
12209,22,4,26,,,,
14135,7,8,15,,,,
3014,3,4,7,,,,
14499,4,0,4,,,,
10764,1,17,18,,,,
16504,1,1,2,,,,
3393,3,11,14,,,,
11351,3,6,9,,,,
13042,1,6,7,,,,
12659,3,7,10,,,,
7583,7,5,12,,,,
15191,10,4,14,,,,
6268,44,51,95,,,,
12218,10,6,16,,,,
1459,48,288,336,,,,
3699,4,8,12,,,,
9379,15,33,48,,,,
10369,4,0,4,,,,
345,4,25,29,,,,
711,111,75,186,,,,
9995,4,0,4,,,,
3704,14,2,16,,,,
16252,4,0,4,,,,
4822,6,11,17,,,,
14834,1,9,10,,,,
15052,9,5,14,,,,
4696,1,51,52,,,,
2359,28,17,45,,,,
15102,1,8,9,,,,
16594,12,0,12,,,,
15362,3,39,42,,,,
16047,17,13,30,,,,
1891,49,11,60,,,,
17219,3,1,4,,,,
13101,7,21,28,,,,
17523,5,1,6,,,,
1157,1,3,4,,,,
17188,15,0,15,,,,
14732,9,25,34,,,,
6663,5,8,13,,,,
14382,1,1,2,,,,
5191,4,4,8,,,,
11123,6,18,24,,,,
16605,6,4,10,,,,
11112,3,4,7,,,,
15762,8,6,14,,,,
2881,22,4,26,,,,
463,2,0,2,,,,
9510,4,1,5,,,,
17640,2,0,2,,,,
169,132,48,180,,,,
16286,1,6,7,,,,
17067,28,0,28,,,,
4333,34,20,54,,,,
4811,16,37,53,,,,
7278,3,1,4,,,,
10137,4,7,11,,,,
4656,12,19,31,,,,
11858,1,0,1,,,,
7473,18,11,29,,,,
3391,2,11,13,,,,
12925,5,11,16,,,,
6542,3,9,12,,,,
5979,2,2,4,,,,
4687,22,19,41,,,,
9090,15,4,19,,,,
3123,13,14,27,,,,
16187,6,22,28,,,,
12278,1,22,23,,,,
16902,13,4,17,,,,
3155,5,4,9,,,,
14389,1,6,7,,,,
1831,42,91,133,,,,
8627,14,7,21,,,,
14999,4,4,8,,,,
8841,1,0,1,,,,
9341,11,7,18,,,,
341,2,8,10,,,,
12253,3,15,18,,,,
8197,12,48,60,,,,
8425,2,0,2,,,,
11803,6,0,6,,,,
13027,33,3,36,,,,
1003,2,4,6,,,,
5436,89,26,115,,,,
969,14,3,17,,,,
4525,31,2,33,,,,
17248,1,6,7,,,,
1694,61,67,128,,,,
8131,79,13,92,,,,
239,18,4,22,,,,
14175,65,26,91,,,,
15971,3,1,4,,,,
15118,4,3,7,,,,
13693,3,5,8,,,,
6600,13,12,25,,,,
7156,18,7,25,,,,
637,8,10,18,,,,
3927,4,2,6,,,,
9089,19,10,29,,,,
4640,5,17,22,,,,
1238,7,5,12,,,,
2310,32,40,72,,,,
10313,21,1,22,,,,
895,28,25,53,,,,
5012,7,18,25,,,,
4436,11,5,16,,,,
8156,104,15,119,,,,
6578,32,7,39,,,,
1533,7,18,25,,,,
16674,15,1,16,,,,
4414,34,1,35,,,,
5096,1,103,104,,,,
12619,2,7,9,,,,
10431,19,0,19,,,,
8519,14,10,24,,,,
13255,1,2,3,,,,
17788,7,1,8,,,,
13785,9,4,13,,,,
16254,2,21,23,,,,
16297,28,1,29,,,,
1253,108,31,139,,,,
2956,55,11,66,,,,
5666,7,4,11,,,,
16933,8,6,14,,,,
3801,30,0,30,,,,
3741,5,29,34,,,,
7803,6,8,14,,,,
1324,6,40,46,,,,
14902,20,23,43,,,,
11830,6,0,6,,,,
17804,6,0,6,,,,
15375,2,10,12,,,,
9203,1,1,2,,,,
8757,16,2,18,,,,
3251,16,7,23,,,,
9044,7,5,12,,,,
10623,2,22,24,,,,
6831,18,1,19,,,,
9730,5,6,11,,,,
13001,3,3,6,,,,
1750,163,40,203,,,,
10283,6,6,12,,,,
3913,65,3,68,,,,
13758,6,8,14,,,,
828,4,5,9,,,,
9031,3,11,14,,,,
9478,1,1,2,,,,
3371,44,10,54,,,,
6262,2,19,21,,,,
13132,26,4,30,,,,
1787,6,22,28,,,,
5178,7,1,8,,,,
3087,9,6,15,,,,
5635,32,13,45,,,,
6982,4,5,9,,,,
2668,21,63,84,,,,
2371,39,0,39,,,,
515,1,0,1,,,,
2349,36,34,70,,,,
3584,3,1,4,,,,
10050,7,50,57,,,,
17616,2,3,5,,,,
3632,5,14,19,,,,
9724,3,18,21,,,,
14636,12,2,14,,,,
4017,2,0,2,,,,
1180,3,6,9,,,,
6063,21,26,47,,,,
7936,2,1,3,,,,
14626,11,11,22,,,,
7785,1,1,2,,,,
5643,22,3,25,,,,
2621,21,44,65,,,,
1473,3,21,24,,,,
4412,137,14,151,,,,
7076,6,1,7,,,,
7496,2,10,12,,,,
362,39,23,62,,,,
15166,1,2,3,,,,
14989,5,10,15,,,,
16158,2,21,23,,,,
1921,87,16,103,,,,
13687,9,6,15,,,,
747,85,16,101,,,,
6101,87,13,100,,,,
7269,17,5,22,,,,
15606,21,18,39,,,,
3586,3,46,49,,,,
1815,227,107,334,,,,
5905,1,2,3,,,,
9234,5,2,7,,,,
11705,18,19,37,,,,
15789,5,1,6,,,,
6704,3,0,3,,,,
4413,113,23,136,,,,
7315,5,11,16,,,,
12148,9,1,10,,,,
14649,5,3,8,,,,
10700,5,17,22,,,,
5728,70,2,72,,,,
11968,2,3,5,,,,
1352,38,8,46,,,,
6869,13,10,23,,,,
13241,12,14,26,,,,
9212,24,0,24,,,,
9927,2,8,10,,,,
4336,6,8,14,,,,
6118,21,5,26,,,,
5402,138,47,185,,,,
377,21,17,38,,,,
8013,19,39,58,,,,
12454,6,20,26,,,,
1869,5,257,262,,,,
9626,2,5,7,,,,
7414,2,3,5,,,,
5333,14,13,27,,,,
2945,17,122,139,,,,
16031,7,40,47,,,,
17150,5,8,13,,,,
16522,1,5,6,,,,
9088,3,2,5,,,,
15770,3,2,5,,,,
571,11,37,48,,,,
10867,13,8,21,,,,
15200,8,1,9,,,,
8865,8,8,16,,,,
11225,12,0,12,,,,
10146,4,27,31,,,,
5464,204,22,226,,,,
8522,34,10,44,,,,
15697,3,2,5,,,,
4562,82,31,113,,,,
13281,5,3,8,,,,
8756,7,8,15,,,,
9829,7,8,15,,,,
7828,5,5,10,,,,
13863,15,4,19,,,,
9757,13,4,17,,,,
578,192,106,298,,,,
15461,3,4,7,,,,
1576,16,0,16,,,,
364,7,34,41,,,,
2207,9,3,12,,,,
16010,17,42,59,,,,
11387,9,3,12,,,,
6879,13,16,29,,,,
14996,4,3,7,,,,
5119,11,33,44,,,,
16712,8,10,18,,,,
6962,71,33,104,,,,
9915,41,3,44,,,,
13271,12,3,15,,,,
17097,6,9,15,,,,
16198,10,9,19,,,,
8277,9,0,9,,,,
16104,4,4,8,,,,
2509,2,7,9,,,,
14572,4,24,28,,,,
8295,25,6,31,,,,
16650,2,0,2,,,,
3042,8,12,20,,,,
7735,12,4,16,,,,
17064,22,26,48,,,,
1873,30,35,65,,,,
17013,2,4,6,,,,
6163,1,21,22,,,,
11429,25,1,26,,,,
9676,12,49,61,,,,
10962,1,2,3,,,,
9675,1,12,13,,,,
10821,3,1,4,,,,
11119,20,14,34,,,,
8958,5,2,7,,,,
6694,4,7,11,,,,
17004,4,2,6,,,,
6460,76,6,82,,,,
10238,20,3,23,,,,
8875,5,9,14,,,,
16603,4,1,5,,,,
15012,21,1,22,,,,
3140,68,69,137,,,,
4628,62,1,63,,,,
2897,7,17,24,,,,
605,8,52,60,,,,
8218,8,3,11,,,,
16887,5,2,7,,,,
7505,1,0,1,,,,
13425,3,33,36,,,,
2924,5,52,57,,,,
11107,6,8,14,,,,
11475,2,8,10,,,,
1004,3,12,15,,,,
17547,1,11,12,,,,
14453,4,5,9,,,,
1933,18,8,26,,,,
10711,6,7,13,,,,
11787,52,122,174,,,,
14054,12,8,20,,,,
5379,20,123,143,,,,
17427,7,5,12,,,,
2519,7,11,18,,,,
6143,23,1,24,,,,
10959,4,5,9,,,,
14482,2,3,5,,,,
9368,1,1,2,,,,
13084,3,3,6,,,,
11274,9,18,27,,,,
12116,1,21,22,,,,
1385,116,149,265,,,,
13718,2,39,41,,,,
8329,36,5,41,,,,
9589,5,0,5,,,,
15538,11,9,20,,,,
9342,4,5,9,,,,
5262,1,22,23,,,,
8135,71,13,84,,,,
16489,2,17,19,,,,
7767,1,48,49,,,,
14884,7,15,22,,,,
12315,6,6,12,,,,
15711,8,3,11,,,,
3481,10,2,12,,,,
12603,19,11,30,,,,
12073,7,10,17,,,,
7854,1,1,2,,,,
7068,4,2,6,,,,
4257,7,7,14,,,,
9287,3,0,3,,,,
446,3,19,22,,,,
8906,2,0,2,,,,
7081,14,30,44,,,,
3672,39,24,63,,,,
2198,7,14,21,,,,
16203,3,22,25,,,,
11862,5,0,5,,,,
11775,25,27,52,,,,
17464,1,3,4,,,,
1929,12,8,20,,,,
5831,30,29,59,,,,
10565,31,4,35,,,,
11776,4,14,18,,,,
2868,16,25,41,,,,
203,68,109,177,,,,
16992,9,2,11,,,,
1374,27,47,74,,,,
2699,25,4,29,,,,
10286,1,6,7,,,,
16266,3,8,11,,,,
8751,41,19,60,,,,
7462,6,5,11,,,,
17704,1,3,4,,,,
4902,1,0,1,,,,
7989,11,1,12,,,,
128,358,59,417,,,,
2752,6,2,8,,,,
17006,3,2,5,,,,
3791,6,5,11,,,,
11702,25,6,31,,,,
10401,9,0,9,,,,
7814,22,7,29,,,,
12145,3,11,14,,,,
5661,13,6,19,,,,
12941,34,1,35,,,,
5037,4,13,17,,,,
13944,8,4,12,,,,
10028,42,21,63,,,,
1586,84,61,145,,,,
12563,6,5,11,,,,
12738,4,0,4,,,,
11092,6,0,6,,,,
8948,6,21,27,,,,
9594,38,4,42,,,,
10207,8,5,13,,,,
6665,9,108,117,,,,
12960,4,1,5,,,,
14609,15,1,16,,,,
5734,7,11,18,,,,
17580,3,7,10,,,,
6156,5,17,22,,,,
12468,44,7,51,,,,
13700,5,4,9,,,,
15260,12,7,19,,,,
9150,1,59,60,,,,
10340,1,4,5,,,,
7464,8,1,9,,,,
13969,2,1,3,,,,
13834,3,1,4,,,,
1878,45,10,55,,,,
10466,8,26,34,,,,
14612,3,7,10,,,,
4079,40,6,46,,,,
10567,21,18,39,,,,
10547,20,64,84,,,,
1415,6,96,102,,,,
2434,116,26,142,,,,
8600,8,43,51,,,,
17579,8,2,10,,,,
9435,6,5,11,,,,
9642,2,3,5,,,,
13996,4,1,5,,,,
1300,25,44,69,,,,
3916,74,21,95,,,,
3246,24,46,70,,,,
9367,9,4,13,,,,
16302,3,4,7,,,,
13655,2,0,2,,,,
10088,16,24,40,,,,
2840,5,10,15,,,,
8716,17,11,28,,,,
5384,177,15,192,,,,
7082,13,7,20,,,,
10051,6,7,13,,,,
6334,21,30,51,,,,
13315,3,2,5,,,,
6091,6,1,7,,,,
6278,19,94,113,,,,
17515,4,2,6,,,,
10818,2,4,6,,,,
16341,9,0,9,,,,
16794,11,1,12,,,,
12465,25,13,38,,,,
13536,2,20,22,,,,
13045,33,12,45,,,,
11152,8,1,9,,,,
5827,9,23,32,,,,
11296,13,2,15,,,,
1241,3,15,18,,,,
13501,17,5,22,,,,
14760,3,6,9,,,,
7861,5,11,16,,,,
2403,17,13,30,,,,
1098,6,7,13,,,,
14019,1,9,10,,,,
7837,13,6,19,,,,
5236,7,50,57,,,,
17374,8,4,12,,,,
15396,38,14,52,,,,
11290,6,7,13,,,,
8405,3,8,11,,,,
15212,4,3,7,,,,
10573,7,2,9,,,,
15739,5,6,11,,,,
494,2,0,2,,,,
6644,12,15,27,,,,
15874,15,0,15,,,,
2450,31,83,114,,,,
10473,21,29,50,,,,
12048,6,1,7,,,,
14655,2,9,11,,,,
7257,10,1,11,,,,
4534,51,7,58,,,,
2192,24,14,38,,,,
9939,1,8,9,,,,
17253,3,1,4,,,,
7349,4,1,5,,,,
15915,2,3,5,,,,
9356,7,13,20,,,,
12845,11,17,28,,,,
12857,3,1,4,,,,
17256,35,4,39,,,,
4968,3,5,8,,,,
16935,3,5,8,,,,
4488,7,1,8,,,,
1920,18,203,221,,,,
9524,11,2,13,,,,
8202,34,13,47,,,,
4514,84,20,104,,,,
2655,15,47,62,,,,
2449,16,35,51,,,,
13860,1,2,3,,,,
5563,22,11,33,,,,
2736,48,15,63,,,,
2518,31,3,34,,,,
5154,1,12,13,,,,
3833,1,18,19,,,,
5676,3,10,13,,,,
4522,3,81,84,,,,
11289,2,1,3,,,,
11815,9,12,21,,,,
11561,34,21,55,,,,
5383,14,147,161,,,,
10358,7,0,7,,,,
8130,55,28,83,,,,
15359,9,24,33,,,,
13816,3,13,16,,,,
17626,1,8,9,,,,
16136,2,6,8,,,,
3888,12,48,60,,,,
12102,11,0,11,,,,
13556,10,4,14,,,,
14144,17,3,20,,,,
447,7,67,74,,,,
6494,25,50,75,,,,
5171,7,8,15,,,,
1480,38,32,70,,,,
13318,3,0,3,,,,
8583,11,10,21,,,,
6146,6,7,13,,,,
3405,4,21,25,,,,
5784,9,4,13,,,,
247,22,12,34,,,,
11375,1,5,6,,,,
10472,13,40,53,,,,
9169,2,1,3,,,,
14899,5,24,29,,,,
3961,94,52,146,,,,
10744,5,15,20,,,,
11811,6,1,7,,,,
11422,3,10,13,,,,
16106,3,22,25,,,,
6462,20,50,70,,,,
611,69,12,81,,,,
12892,12,0,12,,,,
5920,6,68,74,,,,
13257,7,3,10,,,,
16270,13,1,14,,,,
17312,1,13,14,,,,
11413,2,0,2,,,,
2891,26,8,34,,,,
5943,12,0,12,,,,
2987,66,43,109,,,,
16093,22,16,38,,,,
3021,58,26,84,,,,
9447,15,7,22,,,,
16209,7,2,9,,,,
13345,2,16,18,,,,
16710,26,1,27,,,,
1034,2,16,18,,,,
4951,9,20,29,,,,
15491,36,6,42,,,,
1773,96,6,102,,,,
14782,8,2,10,,,,
2383,1,62,63,,,,
4296,64,28,92,,,,
4457,13,3,16,,,,
12502,69,37,106,,,,
15007,4,4,8,,,,
9668,18,10,28,,,,
4912,37,129,166,,,,
16899,1,1,2,,,,
9756,12,6,18,,,,
11138,1,4,5,,,,
4345,52,7,59,,,,
12196,12,1,13,,,,
6537,9,2,11,,,,
4339,8,8,16,,,,
11922,4,2,6,,,,
12010,51,67,118,,,,
9815,17,2,19,,,,
12005,58,132,190,,,,
9168,7,3,10,,,,
9802,5,0,5,,,,
13903,1,20,21,,,,
1860,58,52,110,,,,
81,49,158,207,,,,
17729,7,3,10,,,,
3620,4,1,5,,,,
14530,24,0,24,,,,
11783,12,3,15,,,,
2620,147,98,245,,,,
3543,18,7,25,,,,
8914,2,13,15,,,,
16983,6,1,7,,,,
16744,3,0,3,,,,
9863,21,17,38,,,,
2893,23,21,44,,,,
15633,4,2,6,,,,
11227,5,1,6,,,,
12675,8,2,10,,,,
1765,15,5,20,,,,
11212,3,6,9,,,,
12439,50,58,108,,,,
3260,188,65,253,,,,
7174,5,26,31,,,,
11065,1,6,7,,,,
13965,24,9,33,,,,
4145,1,22,23,,,,
10304,3,2,5,,,,
12924,13,8,21,,,,
5889,5,16,21,,,,
2069,16,53,69,,,,
4276,194,38,232,,,,
14138,6,11,17,,,,
7270,71,5,76,,,,
1902,13,31,44,,,,
564,115,67,182,,,,
5330,17,13,30,,,,
16883,2,4,6,,,,
16070,1,1,2,,,,
6691,6,8,14,,,,
14423,7,2,9,,,,
15047,1,9,10,,,,
16503,3,14,17,,,,
3386,3,0,3,,,,
2641,42,35,77,,,,
15593,2,2,4,,,,
289,55,22,77,,,,
556,19,92,111,,,,
2033,7,21,28,,,,
6957,1,0,1,,,,
16821,12,4,16,,,,
16677,3,0,3,,,,
2072,1,18,19,,,,
4881,13,1,14,,,,
2907,18,23,41,,,,
7853,8,19,27,,,,
14648,1,3,4,,,,
15499,4,4,8,,,,
6362,8,4,12,,,,
14764,3,10,13,,,,
7738,2,2,4,,,,
3345,52,4,56,,,,
13094,25,14,39,,,,
7526,32,44,76,,,,
5011,4,64,68,,,,
15572,6,3,9,,,,
13253,18,6,24,,,,
12483,7,9,16,,,,
1199,6,8,14,,,,
8459,1,9,10,,,,
14259,33,13,46,,,,
7701,16,7,23,,,,
16368,3,0,3,,,,
4475,22,51,73,,,,
12233,4,8,12,,,,
12928,14,2,16,,,,
2878,25,16,41,,,,
3812,41,25,66,,,,
17501,1,8,9,,,,
8983,58,4,62,,,,
10006,3,12,15,,,,
1224,12,3,15,,,,
9619,47,14,61,,,,
9144,4,3,7,,,,
9519,38,11,49,,,,
17456,8,25,33,,,,
3529,5,0,5,,,,
420,2,1,3,,,,
3556,2,9,11,,,,
4889,1,8,9,,,,
8472,1,9,10,,,,
12307,8,10,18,,,,
6186,152,6,158,,,,
13262,4,2,6,,,,
13477,9,2,11,,,,
5058,13,21,34,,,,
3798,2,13,15,,,,
9873,30,0,30,,,,
2971,34,1,35,,,,
15406,9,20,29,,,,
16622,2,0,2,,,,
338,10,1,11,,,,
2771,1,3,4,,,,
15950,5,3,8,,,,
12628,1,1,2,,,,
105,122,100,222,,,,
7528,7,32,39,,,,
3083,31,13,44,,,,
32,4,2,6,,,,
5452,36,159,195,,,,
6825,37,4,41,,,,
9623,4,8,12,,,,
9130,3,1,4,,,,
12647,5,1,6,,,,
10889,1,13,14,,,,
7825,13,5,18,,,,
14262,1,0,1,,,,
14187,14,25,39,,,,
3372,13,61,74,,,,
5757,59,24,83,,,,
3785,5,8,13,,,,
12714,2,5,7,,,,
14907,6,12,18,,,,
16972,2,6,8,,,,
14688,2,3,5,,,,
8116,1,1,2,,,,
17382,5,7,12,,,,
2901,12,14,26,,,,
12256,10,2,12,,,,
6586,36,95,131,,,,
14929,9,6,15,,,,
7233,30,17,47,,,,
6435,16,45,61,,,,
7291,2,0,2,,,,
2090,16,11,27,,,,
6874,2,2,4,,,,
9161,3,7,10,,,,
15628,6,11,17,,,,
11239,1,11,12,,,,
10405,3,16,19,,,,
2428,18,13,31,,,,
3069,4,18,22,,,,
4382,4,16,20,,,,
8631,6,16,22,,,,
16940,1,1,2,,,,
11265,2,51,53,,,,
15306,1,4,5,,,,
2367,35,3,38,,,,
1837,34,27,61,,,,
16380,4,1,5,,,,
204,75,102,177,,,,
10381,2,14,16,,,,
17449,1,5,6,,,,
9220,1,0,1,,,,
15223,3,13,16,,,,
17731,3,16,19,,,,
8149,47,36,83,,,,
11844,4,1,5,,,,
2292,3,15,18,,,,
1642,140,44,184,,,,
13628,1,0,1,,,,
9586,7,39,46,,,,
329,3,2,5,,,,
5910,13,0,13,,,,
7441,14,4,18,,,,
16750,7,8,15,,,,
4337,35,4,39,,,,
10858,8,1,9,,,,
152,15,47,62,,,,
12682,1,17,18,,,,
3323,34,4,38,,,,
11363,3,1,4,,,,
3622,27,0,27,,,,
3041,7,0,7,,,,
13089,5,18,23,,,,
9486,10,3,13,,,,
4323,2,3,5,,,,
1836,29,1,30,,,,
5167,2,13,15,,,,
1115,15,2,17,,,,
8332,6,16,22,,,,
4730,7,17,24,,,,
17094,3,9,12,,,,
5165,2,3,5,,,,
1561,112,51,163,,,,
5931,7,30,37,,,,
7531,124,3,127,,,,
17308,1,5,6,,,,
2260,51,80,131,,,,
6805,11,1,12,,,,
13158,6,3,9,,,,
4950,101,17,118,,,,
1966,15,1,16,,,,
13659,1,5,6,,,,
16184,3,0,3,,,,
11032,4,10,14,,,,
10611,9,31,40,,,,
14210,29,11,40,,,,
4089,13,6,19,,,,
3335,2,0,2,,,,
16295,3,21,24,,,,
9859,17,150,167,,,,
8971,2,40,42,,,,
16484,2,3,5,,,,
1538,9,0,9,,,,
16131,6,1,7,,,,
17760,1,1,2,,,,
5076,5,2,7,,,,
4099,19,82,101,,,,
6499,61,37,98,,,,
13966,14,5,19,,,,
16763,1,1,2,,,,
1219,47,157,204,,,,
15115,1,0,1,,,,
13058,4,44,48,,,,
15690,9,15,24,,,,
15477,6,1,7,,,,
8929,2,3,5,,,,
2158,12,7,19,,,,
10956,3,4,7,,,,
4618,2,5,7,,,,
12293,4,15,19,,,,
8001,29,24,53,,,,
1006,4,11,15,,,,
15868,4,6,10,,,,
14963,5,1,6,,,,
6568,1,9,10,,,,
574,127,153,280,,,,
17445,1,19,20,,,,
17789,4,0,4,,,,
12664,2,6,8,,,,
13759,7,1,8,,,,
14414,9,11,20,,,,
4810,1,37,38,,,,
6365,4,2,6,,,,
7801,11,29,40,,,,
1504,1,1,2,,,,
9775,22,8,30,,,,
15745,7,5,12,,,,
6797,16,27,43,,,,
4708,27,12,39,,,,
17596,1,5,6,,,,
9826,8,3,11,,,,
9311,9,10,19,,,,
9571,11,16,27,,,,
4052,51,19,70,,,,
11674,58,7,65,,,,
10294,3,7,10,,,,
9523,6,21,27,,,,
5253,2,20,22,,,,
13512,1,15,16,,,,
4932,103,17,120,,,,
6597,2,19,21,,,,
6068,14,27,41,,,,
6999,1,0,1,,,,
10534,28,1,29,,,,
2053,3,0,3,,,,
8561,6,25,31,,,,
13413,3,0,3,,,,
7546,36,5,41,,,,
4092,18,42,60,,,,
1784,7,17,24,,,,
9657,4,21,25,,,,
12704,1,10,11,,,,
2691,44,18,62,,,,
6901,2,2,4,,,,
13096,4,2,6,,,,
12828,6,42,48,,,,
3006,25,4,29,,,,
8384,2,3,5,,,,
14804,7,12,19,,,,
4286,28,33,61,,,,
8511,16,13,29,,,,
5595,6,63,69,,,,
10790,15,1,16,,,,
13117,12,2,14,,,,
17448,5,2,7,,,,
8808,6,2,8,,,,
7221,5,12,17,,,,
15319,9,3,12,,,,
11,13,16,29,,,,
17478,4,14,18,,,,
7327,4,4,8,,,,
14118,1,4,5,,,,
12,20,0,20,,,,
3870,32,60,92,,,,
6637,18,44,62,,,,
10876,6,4,10,,,,
10393,2,3,5,,,,
13402,9,4,13,,,,
6746,1,0,1,,,,
15135,4,4,8,,,,
1121,7,22,29,,,,
388,24,246,270,,,,
6538,3,2,5,,,,
3982,6,20,26,,,,
2004,12,49,61,,,,
10902,3,18,21,,,,
9213,11,34,45,,,,
16631,1,0,1,,,,
5372,9,202,211,,,,
5219,23,21,44,,,,
6867,39,10,49,,,,
14820,13,2,15,,,,
6845,19,15,34,,,,
17153,12,32,44,,,,
11704,24,18,42,,,,
12997,3,3,6,,,,
14357,2,7,9,,,,
14584,5,12,17,,,,
2355,85,29,114,,,,
16140,4,8,12,,,,
9315,80,10,90,,,,
4868,3,3,6,,,,
10399,4,16,20,,,,
4236,84,43,127,,,,
426,62,23,85,,,,
8681,6,16,22,,,,
3965,19,12,31,,,,
2439,15,42,57,,,,
358,10,2,12,,,,
5884,13,5,18,,,,
14379,7,6,13,,,,
16265,3,5,8,,,,
9304,4,5,9,,,,
7840,7,3,10,,,,
11988,4,4,8,,,,
17168,10,13,23,,,,
12474,1,17,18,,,,
613,46,17,63,,,,
5028,9,2,11,,,,
17015,3,1,4,,,,
8017,1,18,19,,,,
6106,12,60,72,,,,
15025,12,14,26,,,,
9819,12,2,14,,,,
17430,1,1,2,,,,
6506,40,20,60,,,,
8415,5,11,16,,,,
10259,14,26,40,,,,
2376,84,83,167,,,,
8565,18,15,33,,,,
4283,10,95,105,,,,
11649,37,4,41,,,,
15981,1,2,3,,,,
4878,1,6,7,,,,
11003,7,8,15,,,,
13454,6,3,9,,,,
3569,8,2,10,,,,
3598,19,4,23,,,,
10539,31,16,47,,,,
6052,2,8,10,,,,
2895,1,53,54,,,,
1403,22,12,34,,,,
7604,26,57,83,,,,
15632,9,4,13,,,,
5657,4,5,9,,,,
13275,2,2,4,,,,
16735,2,2,4,,,,
15543,12,8,20,,,,
7722,3,8,11,,,,
12345,4,45,49,,,,
15893,4,2,6,,,,
16800,11,3,14,,,,
16000,33,4,37,,,,
12942,11,2,13,,,,
14000,2,2,4,,,,
7437,27,0,27,,,,
9558,68,4,72,,,,
3192,14,7,21,,,,
9019,16,13,29,,,,
14034,10,8,18,,,,
10257,4,4,8,,,,
5085,3,18,21,,,,
17076,1,0,1,,,,
10521,10,38,48,,,,
7711,3,0,3,,,,
8530,27,34,61,,,,
6038,7,1,8,,,,
17459,1,1,2,,,,
3408,3,0,3,,,,
6532,6,13,19,,,,
48,5,1,6,,,,
5867,7,17,24,,,,
13914,15,0,15,,,,
4964,10,0,10,,,,
8793,30,48,78,,,,
15010,13,0,13,,,,
1474,4,3,7,,,,
12633,13,9,22,,,,
2811,14,14,28,,,,
4961,3,13,16,,,,
28,36,6,42,,,,
2176,1,10,11,,,,
6229,74,27,101,,,,
3035,5,14,19,,,,
5338,17,3,20,,,,
7252,2,2,4,,,,
7731,9,5,14,,,,
7002,10,6,16,,,,
17334,9,6,15,,,,
3024,9,28,37,,,,
12916,12,8,20,,,,
11414,15,2,17,,,,
4027,35,12,47,,,,
11985,11,1,12,,,,
2447,20,58,78,,,,
12692,6,10,16,,,,
15048,16,2,18,,,,
2472,17,24,41,,,,
15383,8,0,8,,,,
3003,13,62,75,,,,
15377,1,5,6,,,,
14007,5,5,10,,,,
11396,4,0,4,,,,
14341,4,1,5,,,,
7683,1,15,16,,,,
1208,2,2,4,,,,
3129,2,2,4,,,,
17091,8,3,11,,,,
4521,20,20,40,,,,
6658,6,57,63,,,,
9218,11,5,16,,,,
15695,5,4,9,,,,
654,2,35,37,,,,
16109,9,0,9,,,,
1960,52,74,126,,,,
13063,1,6,7,,,,
8440,34,26,60,,,,
4083,9,6,15,,,,
1802,561,23,584,,,,
7341,9,5,14,,,,
12713,3,14,17,,,,
14208,1,80,81,,,,
14073,5,17,22,,,,
5584,51,2,53,,,,
10241,1,2,3,,,,
5270,27,21,48,,,,
4883,2,6,8,,,,
8854,4,3,7,,,,
2262,28,5,33,,,,
5129,9,4,13,,,,
14919,11,30,41,,,,
14347,1,1,2,,,,
12237,9,0,9,,,,
4134,3,17,20,,,,
5776,13,2,15,,,,
5356,166,45,211,,,,
10535,33,5,38,,,,
11893,57,2,59,,,,
15696,3,6,9,,,,
9903,15,7,22,,,,
15329,7,2,9,,,,
17832,8,1,9,,,,
17282,2,12,14,,,,
6175,19,3,22,,,,
6321,32,58,90,,,,
8096,3,0,3,,,,
1359,11,42,53,,,,
2467,22,15,37,,,,
811,18,16,34,,,,
8878,12,0,12,,,,
2385,27,100,127,,,,
7836,2,24,26,,,,
5616,12,14,26,,,,
13296,10,0,10,,,,
9884,8,10,18,,,,
5974,6,1,7,,,,
8209,5,26,31,,,,
96,65,36,101,,,,
2745,3,5,8,,,,
6632,14,6,20,,,,
7249,1,9,10,,,,
10662,21,38,59,,,,
8432,20,5,25,,,,
725,36,171,207,,,,
6697,50,47,97,,,,
4163,60,17,77,,,,
7482,11,4,15,,,,
9959,3,2,5,,,,
1813,79,40,119,,,,
13976,6,4,10,,,,
3364,32,41,73,,,,
16678,5,0,5,,,,
11147,2,2,4,,,,
14386,5,10,15,,,,
5055,24,7,31,,,,
6997,11,1,12,,,,
13227,37,18,55,,,,
8570,6,3,9,,,,
10517,24,24,48,,,,
16732,10,6,16,,,,
5468,57,161,218,,,,
15113,4,0,4,,,,
2105,1,0,1,,,,
5466,35,90,125,,,,
367,13,16,29,,,,
12379,1,3,4,,,,
11379,2,2,4,,,,
6343,6,6,12,,,,
8938,3,2,5,,,,
13133,5,3,8,,,,
16454,5,29,34,,,,
9514,8,4,12,,,,
16506,1,6,7,,,,
14225,4,7,11,,,,
10639,7,9,16,,,,
14388,14,20,34,,,,
11220,5,6,11,,,,
1668,38,49,87,,,,
14650,18,4,22,,,,
8446,7,1,8,,,,
15199,3,1,4,,,,
5858,5,3,8,,,,
14149,10,10,20,,,,
1845,47,13,60,,,,
115,5,15,20,,,,
16863,9,1,10,,,,
3871,22,7,29,,,,
1629,55,17,72,,,,
6556,9,17,26,,,,
9507,3,3,6,,,,
3380,22,15,37,,,,
7685,19,12,31,,,,
3029,31,105,136,,,,
2233,10,3,13,,,,
5837,16,15,31,,,,
13711,4,4,8,,,,
12818,64,4,68,,,,
14203,2,51,53,,,,
5660,6,92,98,,,,
13650,15,5,20,,,,
10036,5,3,8,,,,
13620,72,21,93,,,,
4287,42,129,171,,,,
1412,114,72,186,,,,
9419,8,0,8,,,,
15991,15,1,16,,,,
3411,5,15,20,,,,
13663,16,2,18,,,,
3381,8,6,14,,,,
17840,5,0,5,,,,
3447,5,0,5,,,,
9844,38,8,46,,,,
9325,20,7,27,,,,
9740,6,7,13,,,,
5453,13,196,209,,,,
13385,1,10,11,,,,
14724,19,6,25,,,,
13656,13,2,15,,,,
2803,1,2,3,,,,
5762,5,0,5,,,,
4867,6,21,27,,,,
16453,10,18,28,,,,
1650,9,5,14,,,,
13668,3,3,6,,,,
17181,5,3,8,,,,
4142,13,9,22,,,,
6322,61,33,94,,,,
11964,19,18,37,,,,
7773,5,3,8,,,,
14457,1,0,1,,,,
4724,25,27,52,,,,
2605,24,91,115,,,,
17170,2,12,14,,,,
8489,12,8,20,,,,
4701,13,10,23,,,,
3314,49,32,81,,,,
13809,10,37,47,,,,
9103,115,0,115,,,,
6293,27,11,38,,,,
5121,14,2,16,,,,
1996,32,14,46,,,,
15259,3,0,3,,,,
12168,8,0,8,,,,
4495,6,29,35,,,,
6071,38,4,42,,,,
4938,8,16,24,,,,
12243,1,6,7,,,,
8265,2,0,2,,,,
16470,6,7,13,,,,
11628,2,8,10,,,,
13426,2,2,4,,,,
17450,13,0,13,,,,
14829,34,4,38,,,,
1565,51,236,287,,,,
432,9,2,11,,,,
16620,8,3,11,,,,
153,174,92,266,,,,
8729,3,0,3,,,,
15005,1,5,6,,,,
12026,2,7,9,,,,
10222,2,1,3,,,,
11043,23,7,30,,,,
14783,3,0,3,,,,
17039,12,10,22,,,,
8481,19,0,19,,,,
10634,34,9,43,,,,
12302,11,8,19,,,,
12654,2,3,5,,,,
5571,26,23,49,,,,
16065,2,0,2,,,,
8340,3,1,4,,,,
12660,14,34,48,,,,
7524,29,10,39,,,,
6573,4,13,17,,,,
4105,21,20,41,,,,
13827,4,1,5,,,,
15728,11,26,37,,,,
11990,8,6,14,,,,
13674,2,24,26,,,,
3522,13,8,21,,,,
8019,6,44,50,,,,
911,2,5,7,,,,
14471,7,4,11,,,,
8772,25,10,35,,,,
1847,93,66,159,,,,
9569,20,0,20,,,,
6519,2,26,28,,,,
11653,27,5,32,,,,
2,24,5,29,,,,
17075,3,2,5,,,,
16980,2,10,12,,,,
10029,24,56,80,,,,
16204,14,15,29,,,,
5250,1,9,10,,,,
3427,1,1,2,,,,
12403,2,0,2,,,,
16217,7,5,12,,,,
14191,34,32,66,,,,
2497,36,0,36,,,,
2554,9,3,12,,,,
7776,2,16,18,,,,
12841,17,6,23,,,,
12896,1,19,20,,,,
7709,4,2,6,,,,
6500,2,4,6,,,,
13380,2,3,5,,,,
6369,24,2,26,,,,
11703,25,54,79,,,,
9991,9,0,9,,,,
5716,3,8,11,,,,
15727,2,0,2,,,,
7106,3,0,3,,,,
3451,11,8,19,,,,
11277,2,1,3,,,,
13097,5,5,10,,,,
391,52,95,147,,,,
2238,19,71,90,,,,
16651,18,3,21,,,,
10601,3,1,4,,,,
15918,1,1,2,,,,
3677,72,39,111,,,,
14956,25,3,28,,,,
10251,5,3,8,,,,
3220,7,3,10,,,,
10912,35,5,40,,,,
10509,48,15,63,,,,
4942,24,39,63,,,,
4925,12,3,15,,,,
214,1,0,1,,,,
15290,9,1,10,,,,
13908,35,4,39,,,,
2415,102,110,212,,,,
9552,33,6,39,,,,
15484,20,2,22,,,,
7340,4,10,14,,,,
6970,40,11,51,,,,
14369,2,2,4,,,,
14451,3,0,3,,,,
15418,1,10,11,,,,
9041,9,0,9,,,,
12185,6,5,11,,,,
17878,1,2,3,,,,
3141,23,22,45,,,,
16192,1,26,27,,,,
10808,1,49,50,,,,
10977,15,3,18,,,,
928,10,12,22,,,,
7453,1,0,1,,,,
11581,3,3,6,,,,
346,2,4,6,,,,
15829,21,8,29,,,,
856,11,7,18,,,,
4743,10,34,44,,,,
5393,132,16,148,,,,
12747,18,10,28,,,,
6649,14,36,50,,,,
7969,6,30,36,,,,
1619,139,57,196,,,,
8674,7,1,8,,,,
13818,9,13,22,,,,
13557,15,7,22,,,,
6130,3,9,12,,,,
332,7,8,15,,,,
17230,1,5,6,,,,
2961,58,17,75,,,,
11405,1,2,3,,,,
17587,9,5,14,,,,
13942,7,4,11,,,,
954,11,4,15,,,,
6054,14,98,112,,,,
15429,21,9,30,,,,
5607,2,18,20,,,,
1763,12,5,17,,,,
4331,54,5,59,,,,
3297,106,57,163,,,,
11313,15,5,20,,,,
13336,17,1,18,,,,
16520,3,0,3,,,,
14549,23,25,48,,,,
14748,20,11,31,,,,
13647,6,4,10,,,,
5791,9,6,15,,,,
17522,1,1,2,,,,
1564,353,42,395,,,,
866,1,45,46,,,,
14941,2,17,19,,,,
10850,26,0,26,,,,
6891,14,9,23,,,,
14380,9,17,26,,,,
245,7,6,13,,,,
1764,17,19,36,,,,
6405,2,4,6,,,,
14539,25,1,26,,,,
4789,14,1,15,,,,
4718,55,4,59,,,,
8893,8,1,9,,,,
6782,7,26,33,,,,
448,6,10,16,,,,
10580,3,0,3,,,,
3850,54,41,95,,,,
4489,87,8,95,,,,
2545,38,4,42,,,,
300,6,3,9,,,,
15510,10,18,28,,,,
3714,5,2,7,,,,
3503,18,1,19,,,,
5699,3,4,7,,,,
5454,52,75,127,,,,
14075,3,0,3,,,,
4076,58,10,68,,,,
8821,4,1,5,,,,
2360,1,4,5,,,,
17145,2,1,3,,,,
10698,2,24,26,,,,
15503,9,5,14,,,,
5808,5,8,13,,,,
13872,2,7,9,,,,
6066,15,19,34,,,,
15095,5,34,39,,,,
4262,57,159,216,,,,
10679,4,1,5,,,,
14278,12,2,14,,,,
5290,10,6,16,,,,
5826,4,22,26,,,,
9521,1,25,26,,,,
14658,8,22,30,,,,
12884,4,2,6,,,,
11895,2,6,8,,,,
778,91,32,123,,,,
9734,21,4,25,,,,
3324,12,42,54,,,,
15248,16,1,17,,,,
2753,44,13,57,,,,
16231,2,1,3,,,,
11867,3,37,40,,,,
10132,3,0,3,,,,
1221,2,10,12,,,,
4900,5,5,10,,,,
6417,49,22,71,,,,
17315,5,1,6,,,,
9149,5,2,7,,,,
2159,7,1,8,,,,
9925,8,32,40,,,,
3117,76,5,81,,,,
8180,9,15,24,,,,
9410,7,15,22,,,,
8744,3,4,7,,,,
12406,12,13,25,,,,
7538,4,97,101,,,,
6513,37,12,49,,,,
762,16,13,29,,,,
14302,1,2,3,,,,
3535,2,0,2,,,,
15686,20,2,22,,,,
12035,2,15,17,,,,
16419,15,3,18,,,,
15665,1,0,1,,,,
4678,49,9,58,,,,
7007,3,0,3,,,,
9264,1,1,2,,,,
12688,10,5,15,,,,
15435,30,1,31,,,,
3290,50,98,148,,,,
6745,2,6,8,,,,
16979,7,15,22,,,,
4415,74,37,111,,,,
2461,14,31,45,,,,
15764,10,4,14,,,,
6735,2,0,2,,,,
3395,7,10,17,,,,
1047,99,0,99,,,,
9431,12,41,53,,,,
5263,15,26,41,,,,
8945,4,1,5,,,,
11505,7,27,34,,,,
8665,6,3,9,,,,
8241,1,55,56,,,,
13444,2,4,6,,,,
4468,28,10,38,,,,
13883,31,10,41,,,,
3702,6,25,31,,,,
16117,9,12,21,,,,
229,11,4,15,,,,
4061,9,8,17,,,,
16927,6,0,6,,,,
168,227,97,324,,,,
16913,1,0,1,,,,
11609,1,3,4,,,,
11471,3,2,5,,,,
13719,14,20,34,,,,
13316,1,2,3,,,,
15341,23,1,24,,,,
4322,96,31,127,,,,
13386,10,10,20,,,,
11970,20,14,34,,,,
14151,10,7,17,,,,
13017,3,23,26,,,,
17337,2,1,3,,,,
399,16,2,18,,,,
17689,2,3,5,,,,
11306,13,7,20,,,,
5079,2,16,18,,,,
8563,10,29,39,,,,
2384,43,57,100,,,,
14991,18,3,21,,,,
12551,13,4,17,,,,
1926,9,32,41,,,,
443,30,10,40,,,,
7444,2,2,4,,,,
6841,43,3,46,,,,
12397,13,4,17,,,,
13481,11,2,13,,,,
10345,7,9,16,,,,
13057,18,29,47,,,,
6755,35,35,70,,,,
3205,3,3,6,,,,
1038,10,9,19,,,,
3425,1,10,11,,,,
3410,2,10,12,,,,
13623,29,30,59,,,,
17186,4,4,8,,,,
6881,23,9,32,,,,
17412,4,2,6,,,,
5545,22,12,34,,,,
12251,7,0,7,,,,
16189,10,8,18,,,,
12770,2,5,7,,,,
10606,30,4,34,,,,
1848,135,45,180,,,,
1284,7,12,19,,,,
10682,6,5,11,,,,
16103,13,5,18,,,,
16476,7,5,12,,,,
12696,1,2,3,,,,
17773,6,0,6,,,,
7397,1,4,5,,,,
17421,2,0,2,,,,
1956,23,68,91,,,,
10645,3,4,7,,,,
4815,1,14,15,,,,
10350,4,3,7,,,,
7184,11,1,12,,,,
3734,9,88,97,,,,
5621,8,3,11,,,,
12012,27,106,133,,,,
3236,1,52,53,,,,
843,8,9,17,,,,
1371,25,8,33,,,,
12499,5,18,23,,,,
5254,11,13,24,,,,
9171,12,6,18,,,,
11311,2,2,4,,,,
8661,1,19,20,,,,
13186,90,11,101,,,,
3504,8,42,50,,,,
7746,32,34,66,,,,
14703,2,0,2,,,,
16514,6,1,7,,,,
17262,6,3,9,,,,
7952,9,0,9,,,,
8012,19,45,64,,,,
2324,16,82,98,,,,
6072,3,11,14,,,,
16928,13,2,15,,,,
9933,2,1,3,,,,
12333,6,9,15,,,,
12722,5,7,12,,,,
14981,1,23,24,,,,
11891,9,1,10,,,,
3130,3,14,17,,,,
10095,32,51,83,,,,
7987,3,3,6,,,,
5682,16,22,38,,,,
149,13,25,38,,,,
17000,26,12,38,,,,
2587,8,9,17,,,,
11034,11,21,32,,,,
3641,16,6,22,,,,
1742,58,121,179,,,,
4604,5,8,13,,,,
8758,7,40,47,,,,
1235,12,28,40,,,,
9876,7,23,30,,,,
10708,4,8,12,,,,
8581,3,12,15,,,,
10419,1,1,2,,,,
6576,7,12,19,,,,
13029,4,3,7,,,,
2570,49,19,68,,,,
400,2,42,44,,,,
15157,1,6,7,,,,
7537,61,22,83,,,,
10749,5,0,5,,,,
9905,5,10,15,,,,
642,1,23,24,,,,
2663,23,8,31,,,,
3950,54,5,59,,,,
13405,7,11,18,,,,
3071,1,11,12,,,,
16911,7,2,9,,,,
4587,31,4,35,,,,
7508,5,29,34,,,,
12646,9,3,12,,,,
7900,34,11,45,,,,
991,13,2,15,,,,
13268,9,9,18,,,,
6648,11,2,13,,,,
5530,1,0,1,,,,
11446,4,2,6,,,,
767,11,19,30,,,,
17612,1,4,5,,,,
4768,10,16,26,,,,
16054,25,11,36,,,,
11921,1,1,2,,,,
13054,9,0,9,,,,
1214,1,14,15,,,,
16789,6,4,10,,,,
4578,4,24,28,,,,
3184,16,11,27,,,,
17483,2,7,9,,,,
1369,34,8,42,,,,
4767,23,18,41,,,,
6346,5,3,8,,,,
456,10,1,11,,,,
17690,4,1,5,,,,
3052,1,35,36,,,,
4241,4,3,7,,,,
16044,6,19,25,,,,
14188,26,12,38,,,,
2550,7,42,49,,,,
11687,11,30,41,,,,
17388,1,0,1,,,,
3224,1,6,7,,,,
8342,10,2,12,,,,
2297,46,212,258,,,,
15153,5,6,11,,,,
8642,19,14,33,,,,
4274,3,10,13,,,,
6243,6,6,12,,,,
17904,1,0,1,,,,
9052,3,0,3,,,,
7567,118,9,127,,,,
8778,30,32,62,,,,
15086,16,22,38,,,,
17283,7,14,21,,,,
2401,73,103,176,,,,
12768,2,5,7,,,,
2387,10,64,74,,,,
14969,8,16,24,,,,
2563,14,3,17,,,,
7996,10,60,70,,,,
4571,14,40,54,,,,
3694,2,18,20,,,,
16315,5,8,13,,,,
3104,16,1,17,,,,
6037,2,0,2,,,,
3498,4,1,5,,,,
10828,7,54,61,,,,
9555,4,62,66,,,,
15173,1,0,1,,,,
16262,2,0,2,,,,
14103,10,0,10,,,,
11035,2,18,20,,,,
8608,10,10,20,,,,
8419,1,0,1,,,,
221,1,7,8,,,,
9266,3,5,8,,,,
717,136,6,142,,,,
11442,15,2,17,,,,
14943,7,17,24,,,,
7452,4,2,6,,,,
206,92,4,96,,,,
8692,23,2,25,,,,
8041,5,4,9,,,,
9666,8,16,24,,,,
13709,1,15,16,,,,
13781,8,3,11,,,,
16287,14,2,16,,,,
15825,3,19,22,,,,
16721,1,5,6,,,,
10728,4,7,11,,,,
3930,3,256,259,,,,
12336,16,24,40,,,,
9166,11,21,32,,,,
840,4,3,7,,,,
10452,12,3,15,,,,
9382,17,38,55,,,,
618,4,0,4,,,,
17802,4,2,6,,,,
4551,20,11,31,,,,
8134,37,34,71,,,,
7472,28,8,36,,,,
5327,23,4,27,,,,
12023,2,15,17,,,,
7659,24,47,71,,,,
200,23,16,39,,,,
12812,3,1,4,,,,
815,20,33,53,,,,
2675,65,3,68,,,,
6030,7,4,11,,,,
3293,14,13,27,,,,
8009,5,19,24,,,,
3755,10,31,41,,,,
16451,11,7,18,,,,
12934,5,24,29,,,,
6947,8,3,11,,,,
16342,5,1,6,,,,
84,50,28,78,,,,
16607,6,5,11,,,,
2906,104,30,134,,,,
15291,10,5,15,,,,
9170,14,16,30,,,,
10395,2,0,2,,,,
16637,28,0,28,,,,
11235,19,2,21,,,,
14124,2,7,9,,,,
17349,5,2,7,,,,
14761,5,5,10,,,,
13320,9,2,11,,,,
13742,16,52,68,,,,
1995,20,43,63,,,,
5489,63,57,120,,,,
5389,67,140,207,,,,
10194,8,8,16,,,,
173,16,130,146,,,,
1182,31,15,46,,,,
11036,2,13,15,,,,
315,19,20,39,,,,
9563,14,16,30,,,,
5526,180,27,207,,,,
16447,7,2,9,,,,
13360,1,3,4,,,,
9123,3,6,9,,,,
8038,1,4,5,,,,
14467,12,0,12,,,,
12533,6,16,22,,,,
17339,11,3,14,,,,
5928,4,9,13,,,,
11566,5,5,10,,,,
1322,47,22,69,,,,
5215,10,11,21,,,,
5830,9,0,9,,,,
14447,1,13,14,,,,
2520,15,111,126,,,,
15250,2,33,35,,,,
11275,25,4,29,,,,
6489,36,9,45,,,,
6161,2,2,4,,,,
1711,135,140,275,,,,
1207,3,5,8,,,,
13137,2,7,9,,,,
16011,4,42,46,,,,
8469,9,29,38,,,,
9501,29,5,34,,,,
3454,28,4,32,,,,
12204,34,6,40,,,,
8400,31,0,31,,,,
6757,26,10,36,,,,
17800,1,0,1,,,,
1283,5,29,34,,,,
17818,2,3,5,,,,
1494,1,5,6,,,,
2795,2,1,3,,,,
1827,77,99,176,,,,
10274,8,1,9,,,,
12749,34,1,35,,,,
5864,21,31,52,,,,
14881,19,28,47,,,,
331,2,7,9,,,,
9679,21,34,55,,,,
10171,2,23,25,,,,
709,4,14,18,,,,
9649,26,34,60,,,,
277,2,18,20,,,,
6715,55,54,109,,,,
10809,4,8,12,,,,
8099,1,21,22,,,,
9950,9,6,15,,,,
11344,86,61,147,,,,
10656,13,2,15,,,,
3063,10,22,32,,,,
11907,18,7,25,,,,
6764,13,0,13,,,,
1746,58,61,119,,,,
2118,12,18,30,,,,
8536,12,63,75,,,,
13986,1,3,4,,,,
3995,15,7,22,,,,
724,98,243,341,,,,
9037,72,13,85,,,,
14445,6,9,15,,,,
9038,10,17,27,,,,
11192,3,21,24,,,,
1752,56,125,181,,,,
14936,1,1,2,,,,
14167,7,5,12,,,,
4915,19,16,35,,,,
1496,1,4,5,,,,
16133,4,0,4,,,,
1582,9,23,32,,,,
9254,1,1,2,,,,
17508,4,2,6,,,,
11963,7,6,13,,,,
8299,6,1,7,,,,
5917,20,26,46,,,,
9495,1,5,6,,,,
2315,24,58,82,,,,
8359,14,29,43,,,,
7787,7,1,8,,,,
733,210,69,279,,,,
12820,2,0,2,,,,
8495,13,4,17,,,,
12037,3,4,7,,,,
9288,28,14,42,,,,
17169,13,1,14,,,,
13498,1,0,1,,,,
6097,57,24,81,,,,
2014,1,103,104,,,,
4159,16,11,27,,,,
17162,6,1,7,,,,
4982,2,1,3,,,,
3009,9,6,15,,,,
5647,2,5,7,,,,
7764,17,0,17,,,,
15604,9,16,25,,,,
8795,93,28,121,,,,
2749,14,1,15,,,,
12320,10,11,21,,,,
16955,2,0,2,,,,
15735,3,8,11,,,,
13810,9,11,20,,,,
5442,29,189,218,,,,
5922,11,20,31,,,,
13270,1,1,2,,,,
7609,2,13,15,,,,
4647,14,11,25,,,,
8939,1,12,13,,,,
10325,11,24,35,,,,
11116,3,6,9,,,,
10630,11,9,20,,,,
16587,2,4,6,,,,
8541,52,19,71,,,,
4465,13,1,14,,,,
8647,4,0,4,,,,
11024,5,2,7,,,,
10747,5,7,12,,,,
2408,39,96,135,,,,
4416,1,2,3,,,,
151,163,68,231,,,,
9097,9,43,52,,,,
9597,19,6,25,,,,
208,117,158,275,,,,
15398,7,23,30,,,,
795,13,24,37,,,,
3057,29,0,29,,,,
6679,80,111,191,,,,
6968,10,0,10,,,,
403,30,1,31,,,,
11384,17,8,25,,,,
3929,17,50,67,,,,
14844,1,13,14,,,,
5585,10,3,13,,,,
13324,4,3,7,,,,
4078,4,12,16,,,,
14939,3,26,29,,,,
6107,9,38,47,,,,
4277,49,48,97,,,,
13449,5,8,13,,,,
2687,19,11,30,,,,
11165,3,16,19,,,,
7970,37,26,63,,,,
9404,1,5,6,,,,
1381,13,79,92,,,,
9858,21,10,31,,,,
9298,1,0,1,,,,
3412,54,1,55,,,,
12330,162,2,164,,,,
7885,6,1,7,,,,
15902,8,0,8,,,,
15079,8,0,8,,,,
6449,18,3,21,,,,
15555,8,3,11,,,,
13078,3,9,12,,,,
4693,42,26,68,,,,
15146,7,7,14,,,,
12221,2,0,2,,,,
17706,5,1,6,,,,
1810,68,61,129,,,,
9131,6,1,7,,,,
7124,9,7,16,,,,
1842,31,14,45,,,,
4271,11,4,15,,,,
11813,12,11,23,,,,
4304,22,14,36,,,,
16455,7,1,8,,,,
1366,87,21,108,,,,
6387,8,23,31,,,,
16253,5,7,12,,,,
3574,4,22,26,,,,
9181,3,2,5,,,,
17628,6,4,10,,,,
2664,84,30,114,,,,
13920,3,2,5,,,,
8884,8,1,9,,,,
11472,1,3,4,,,,
16711,2,19,21,,,,
14883,6,12,18,,,,
6536,3,5,8,,,,
3636,13,16,29,,,,
3917,60,31,91,,,,
3389,3,4,7,,,,
1721,2,17,19,,,,
1052,34,8,42,,,,
5749,1,2,3,,,,
3990,3,1,4,,,,
407,477,84,561,,,,
8188,6,40,46,,,,
2209,3,21,24,,,,
6636,8,26,34,,,,
7000,3,6,9,,,,
5619,81,11,92,,,,
354,4,3,7,,,,
17327,5,4,9,,,,
1363,22,5,27,,,,
10791,1,25,26,,,,
12326,5,8,13,,,,
14340,7,2,9,,,,
421,11,0,11,,,,
11743,10,33,43,,,,
14365,5,4,9,,,,
2304,12,83,95,,,,
12347,4,29,33,,,,
16420,3,3,6,,,,
17432,9,2,11,,,,
16628,1,6,7,,,,
13005,18,9,27,,,,
14606,12,0,12,,,,
14434,5,14,19,,,,
753,63,11,74,,,,
1537,2,2,4,,,,
818,2,7,9,,,,
12944,2,3,5,,,,
108,37,66,103,,,,
7391,35,11,46,,,,
14028,4,14,18,,,,
9874,17,7,24,,,,
3783,1,5,6,,,,
15127,12,0,12,,,,
10493,52,11,63,,,,
15857,5,2,7,,,,
2168,62,11,73,,,,
4790,1,11,12,,,,
2258,10,9,19,,,,
1053,27,6,33,,,,
8973,9,8,17,,,,
11814,13,8,21,,,,
6144,11,2,13,,,,
13278,3,2,5,,,,
17058,9,28,37,,,,
8122,5,7,12,,,,
8178,15,13,28,,,,
11866,1,10,11,,,,
14600,17,6,23,,,,
659,88,108,196,,,,
3072,4,17,21,,,,
3365,1,5,6,,,,
13841,4,2,6,,,,
792,11,10,21,,,,
10705,9,34,43,,,,
8830,3,4,7,,,,
1907,244,7,251,,,,
653,67,31,98,,,,
6771,1,15,16,,,,
13018,3,6,9,,,,
12151,1,0,1,,,,
5118,4,12,16,,,,
6376,1,3,4,,,,
2390,56,21,77,,,,
14645,4,3,7,,,,
10777,1,1,2,,,,
3754,69,9,78,,,,
9788,18,4,22,,,,
3354,97,165,262,,,,
1104,2,4,6,,,,
1288,27,17,44,,,,
5580,7,4,11,,,,
2056,52,48,100,,,,
4327,84,1,85,,,,
11731,37,21,58,,,,
5132,12,6,18,,,,
16831,2,0,2,,,,
12834,4,10,14,,,,
1215,55,34,89,,,,
17420,13,1,14,,,,
11722,5,48,53,,,,
6274,7,22,29,,,,
15534,5,8,13,,,,
937,35,6,41,,,,
3030,29,48,77,,,,
17422,3,5,8,,,,
2847,9,42,51,,,,
15428,26,5,31,,,,
10990,1,4,5,,,,
7075,4,2,6,,,,
12648,1,3,4,,,,
623,84,13,97,,,,
7151,19,7,26,,,,
8742,5,11,16,,,,
4770,18,22,40,,,,
14316,12,12,24,,,,
11781,12,131,143,,,,
17063,23,6,29,,,,
17583,6,0,6,,,,
6639,11,5,16,,,,
4643,32,15,47,,,,
6248,20,42,62,,,,
9970,4,3,7,,,,
8691,2,3,5,,,,
3770,10,22,32,,,,
14500,9,2,11,,,,
10616,7,23,30,,,,
5428,17,77,94,,,,
7522,33,47,80,,,,
9267,1,2,3,,,,
11637,14,4,18,,,,
1680,78,113,191,,,,
13576,3,5,8,,,,
8387,13,1,14,,,,
8573,5,108,113,,,,
10817,1,2,3,,,,
17771,1,0,1,,,,
6448,6,9,15,,,,
13049,1,0,1,,,,
3811,2,0,2,,,,
6319,12,53,65,,,,
3363,27,9,36,,,,
15921,2,0,2,,,,
2242,34,20,54,,,,
16280,4,4,8,,,,
14026,15,10,25,,,,
6357,2,9,11,,,,
10188,19,48,67,,,,
8255,19,3,22,,,,
8260,23,45,68,,,,
9831,8,5,13,,,,
5145,2,2,4,,,,
16267,4,3,7,,,,
7705,6,9,15,,,,
4926,3,12,15,,,,
10615,8,33,41,,,,
13906,1,3,4,,,,
5126,4,90,94,,,,
9142,2,18,20,,,,
5360,34,21,55,,,,
12463,99,40,139,,,,
17433,3,7,10,,,,
13938,2,10,12,,,,
7857,13,21,34,,,,
3774,3,1,4,,,,
10514,13,8,21,,,,
13772,12,0,12,,,,
12508,3,13,16,,,,
1044,36,10,46,,,,
16367,1,0,1,,,,
11972,9,0,9,,,,
16535,3,13,16,,,,
6653,5,13,18,,,,
5419,174,10,184,,,,
8922,12,9,21,,,,
3291,36,17,53,,,,
2077,13,2,15,,,,
2802,1,0,1,,,,
9098,80,177,257,,,,
14685,4,5,9,,,,
12851,18,0,18,,,,
12963,3,12,15,,,,
6814,7,0,7,,,,
12993,16,9,25,,,,
1944,11,7,18,,,,
12778,3,3,6,,,,
7614,2,8,10,,,,
9084,44,18,62,,,,
11079,8,11,19,,,,
5525,176,11,187,,,,
12319,19,16,35,,,,
10585,5,3,8,,,,
655,13,24,37,,,,
13717,31,22,53,,,,
6267,103,66,169,,,,
12746,1,3,4,,,,
9930,28,0,28,,,,
9049,72,43,115,,,,
4247,9,1,10,,,,
13053,4,2,6,,,,
7581,26,3,29,,,,
4662,31,2,33,,,,
13211,24,44,68,,,,
15881,8,0,8,,,,
3311,5,13,18,,,,
14027,8,0,8,,,,
2078,22,11,33,,,,
6056,30,15,45,,,,
16245,7,2,9,,,,
10355,2,0,2,,,,
15284,35,33,68,,,,
935,23,13,36,,,,
1937,21,40,61,,,,
145,78,131,209,,,,
13661,20,13,33,,,,
16222,6,7,13,,,,
4352,9,5,14,,,,
14586,4,0,4,,,,
17121,4,2,6,,,,
14172,61,17,78,,,,
788,12,5,17,,,,
1346,100,8,108,,,,
2204,11,15,26,,,,
1271,5,15,20,,,,
1146,13,6,19,,,,
15650,16,2,18,,,,
10911,20,3,23,,,,
1304,4,34,38,,,,
10034,14,0,14,,,,
7486,3,6,9,,,,
10344,3,4,7,,,,
1621,18,0,18,,,,
14780,5,38,43,,,,
6124,6,4,10,,,,
7422,10,11,21,,,,
8411,3,0,3,,,,
12858,1,1,2,,,,
16991,1,4,5,,,,
5527,8,8,16,,,,
2266,4,3,7,,,,
2718,43,37,80,,,,
13366,2,0,2,,,,
901,36,8,44,,,,
13676,2,5,7,,,,
5999,38,3,41,,,,
3513,1,23,24,,,,
12031,9,3,12,,,,
13367,1,4,5,,,,
15625,4,9,13,,,,
11291,1,2,3,,,,
955,4,2,6,,,,
10423,24,9,33,,,,
3654,3,87,90,,,,
8221,76,12,88,,,,
3239,7,9,16,,,,
47,9,17,26,,,,
12546,2,15,17,,,,
5394,42,136,178,,,,
9344,2,5,7,,,,
56,7,18,25,,,,
9354,13,9,22,,,,
10701,5,6,11,,,,
4230,3,26,29,,,,
12649,4,4,8,,,,
1329,49,13,62,,,,
6690,7,3,10,,,,
16837,24,2,26,,,,
718,56,13,69,,,,
7744,1,13,14,,,,
7228,11,1,12,,,,
10788,14,30,44,,,,
14101,18,9,27,,,,
11960,6,10,16,,,,
11575,5,7,12,,,,
12650,2,6,8,,,,
7957,19,0,19,,,,
17352,5,4,9,,,,
632,47,36,83,,,,
10023,1,21,22,,,,
17555,8,5,13,,,,
11954,18,1,19,,,,
10077,9,11,20,,,,
3470,14,10,24,,,,
8555,41,3,44,,,,
17775,1,0,1,,,,
17209,9,2,11,,,,
1274,1,4,5,,,,
532,10,0,10,,,,
16917,19,18,37,,,,
454,29,41,70,,,,
9985,6,19,25,,,,
102,14,35,49,,,,
13738,4,13,17,,,,
14190,30,17,47,,,,
4022,5,9,14,,,,
16672,15,19,34,,,,
10811,1,5,6,,,,
11421,1,0,1,,,,
5015,2,3,5,,,,
746,13,3,16,,,,
5345,122,40,162,,,,
4976,1,0,1,,,,
5897,2,47,49,,,,
15498,10,2,12,,,,
16597,2,1,3,,,,
1555,39,0,39,,,,
6252,7,5,12,,,,
7207,3,0,3,,,,
17038,3,25,28,,,,
13202,12,23,35,,,,
2117,1,5,6,,,,
2542,2,8,10,,,,
5317,6,36,42,,,,
10090,5,6,11,,,,
5299,22,26,48,,,,
3191,2,5,7,,,,
3004,10,19,29,,,,
5879,6,6,12,,,,
2229,3,18,21,,,,
12308,10,4,14,,,,
12040,13,9,22,,,,
8768,1,15,16,,,,
7642,12,0,12,,,,
5025,25,0,25,,,,
12488,12,39,51,,,,
378,18,12,30,,,,
15913,18,6,24,,,,
9318,22,0,22,,,,
10221,16,5,21,,,,
3322,4,43,47,,,,
1222,10,22,32,,,,
12217,9,11,20,,,,
172,38,67,105,,,,
2585,9,18,27,,,,
2912,12,10,22,,,,
4113,6,9,15,,,,
11060,7,10,17,,,,
5805,2,2,4,,,,
2957,16,197,213,,,,
8981,36,86,122,,,,
517,2,0,2,,,,
1572,21,297,318,,,,
9885,2,2,4,,,,
6380,1,0,1,,,,
14367,15,31,46,,,,
192,32,86,118,,,,
13479,10,8,18,,,,
2888,28,18,46,,,,
13560,22,7,29,,,,
8338,31,27,58,,,,
10068,14,58,72,,,,
12420,5,5,10,,,,
5065,24,0,24,,,,
10554,11,41,52,,,,
3116,15,22,37,,,,
4717,20,8,28,,,,
16627,10,4,14,,,,
1176,4,1,5,,,,
12304,8,2,10,,,,
12610,38,25,63,,,,
15322,9,4,13,,,,
8976,10,1,11,,,,
3786,2,1,3,,,,
12758,3,2,5,,,,
11627,6,5,11,,,,
1682,49,104,153,,,,
16511,2,5,7,,,,
12523,6,2,8,,,,
4535,23,51,74,,,,
14189,5,55,60,,,,
8278,1,3,4,,,,
12558,1,7,8,,,,
10041,30,14,44,,,,
4836,10,4,14,,,,
14372,6,3,9,,,,
11221,8,12,20,,,,
4766,44,5,49,,,,
4393,6,17,23,,,,
7920,4,7,11,,,,
1076,4,7,11,,,,
4250,1,0,1,,,,
14449,3,4,7,,,,
9040,23,12,35,,,,
7613,3,7,10,,,,
6809,16,9,25,,,,
6178,5,10,15,,,,
2286,10,39,49,,,,
11314,5,2,7,,,,
2788,2,0,2,,,,
14620,10,11,21,,,,
2950,7,7,14,,,,
948,11,7,18,,,,
9309,1,3,4,,,,
2578,8,4,12,,,,
16707,2,3,5,,,,
9702,1,3,4,,,,
4340,7,2,9,,,,
6795,12,38,50,,,,
2670,97,88,185,,,,
9485,8,6,14,,,,
10897,5,2,7,,,,
9557,6,18,24,,,,
10642,34,73,107,,,,
2996,50,3,53,,,,
1257,2,5,7,,,,
8171,30,46,76,,,,
16647,19,10,29,,,,
10916,8,21,29,,,,
15470,23,7,30,,,,
8861,3,2,5,,,,
8916,16,1,17,,,,
1531,23,10,33,,,,
15600,10,7,17,,,,
15919,2,2,4,,,,
13035,14,3,17,,,,
17124,2,29,31,,,,
3749,6,43,49,,,,
2316,13,310,323,,,,
4023,17,3,20,,,,
16618,14,14,28,,,,
1774,20,10,30,,,,
2333,31,369,400,,,,
11774,8,15,23,,,,
14535,3,2,5,,,,
15639,3,6,9,,,,
5987,53,1,54,,,,
10356,147,6,153,,,,
503,201,160,361,,,,
10920,9,8,17,,,,
2896,3,228,231,,,,
1707,100,7,107,,,,
9769,5,9,14,,,,
7212,19,20,39,,,,
3743,62,0,62,,,,
17062,3,8,11,,,,
6261,13,11,24,,,,
3286,6,12,18,,,,
4432,54,27,81,,,,
17301,2,1,3,,,,
1342,15,41,56,,,,
2792,15,27,42,,,,
4109,25,27,52,,,,
2975,29,5,34,,,,
15726,2,0,2,,,,
9935,11,0,11,,,,
1879,99,21,120,,,,
2060,1,3,4,,,,
11001,3,1,4,,,,
8211,21,38,59,,,,
15609,5,0,5,,,,
6232,18,11,29,,,,
7004,2,0,2,,,,
6813,6,5,11,,,,
2579,20,1,21,,,,
675,22,50,72,,,,
17870,2,0,2,,,,
17572,3,9,12,,,,
4566,13,21,34,,,,
2293,176,30,206,,,,
17564,8,5,13,,,,
5815,6,0,6,,,,
10978,2,1,3,,,,
8127,20,39,59,,,,
4147,26,42,68,,,,
1630,30,50,80,,,,
9022,32,4,36,,,,
5152,1,4,5,,,,
16557,2,2,4,,,,
2486,7,9,16,,,,
12126,14,5,19,,,,
929,1,65,66,,,,
11463,7,1,8,,,,
6545,8,2,10,,,,
2701,1,52,53,,,,
10377,3,9,12,,,,
1674,143,36,179,,,,
7182,9,10,19,,,,
14214,25,21,46,,,,
14605,10,5,15,,,,
434,49,26,75,,,,
9273,1,8,9,,,,
10427,1,8,9,,,,
1708,25,61,86,,,,
17362,1,1,2,,,,
7516,45,104,149,,,,
712,75,19,94,,,,
2636,27,193,220,,,,
2465,5,25,30,,,,
12923,6,5,11,,,,
17178,3,1,4,,,,
5671,13,5,18,,,,
4574,1,15,16,,,,
11482,4,28,32,,,,
11587,32,3,35,,,,
2731,67,62,129,,,,
2036,1,2,3,,,,
5725,12,5,17,,,,
13068,4,2,6,,,,
3745,12,34,46,,,,
1242,3,28,31,,,,
15104,12,4,16,,,,
11744,6,30,36,,,,
9120,1,3,4,,,,
4844,1,1,2,,,,
11293,5,3,8,,,,
11892,4,4,8,,,,
7688,1,1,2,,,,
5373,170,29,199,,,,
16298,3,7,10,,,,
12852,3,4,7,,,,
6155,3,0,3,,,,
13423,12,11,23,,,,
3420,28,1,29,,,,
12080,6,5,11,,,,
2914,31,27,58,,,,
7918,9,11,20,,,,
14102,1,0,1,,,,
6702,43,34,77,,,,
9618,1,7,8,,,,
5125,5,58,63,,,,
7737,3,1,4,,,,
8584,8,6,14,,,,
13410,12,9,21,,,,
17120,4,5,9,,,,
14827,27,3,30,,,,
11398,31,8,39,,,,
16687,39,1,40,,,,
1431,80,28,108,,,,
6079,8,1,9,,,,
12117,54,25,79,,,,
16168,2,5,7,,,,
10846,2,2,4,,,,
15054,21,9,30,,,,
12783,5,9,14,,,,
5638,2,5,7,,,,
1026,9,2,11,,,,
10769,4,5,9,,,,
10810,14,3,17,,,,
16084,49,1,50,,,,
17641,3,7,10,,,,
13362,11,12,23,,,,
2954,5,2,7,,,,
16449,1,1,2,,,,
6315,1,16,17,,,,
11717,34,14,48,,,,
1832,110,95,205,,,,
387,44,9,53,,,,
15069,5,0,5,,,,
4546,29,12,41,,,,
17521,3,8,11,,,,
6188,2,5,7,,,,
10079,8,4,12,,,,
10538,81,1,82,,,,
16720,11,0,11,,,,
8554,19,67,86,,,,
9699,8,2,10,,,,
17453,4,10,14,,,,
118,38,15,53,,,,
5451,39,84,123,,,,
11688,49,6,55,,,,
6806,9,1,10,,,,
1088,9,4,13,,,,
260,29,42,71,,,,
10830,5,7,12,,,,
4228,1,1,2,,,,
16639,8,11,19,,,,
6141,5,0,5,,,,
11337,98,4,102,,,,
10519,13,23,36,,,,
2337,17,15,32,,,,
5302,8,7,15,,,,
17619,6,0,6,,,,
6852,18,3,21,,,,
12568,21,11,32,,,,
13182,15,26,41,,,,
6747,5,1,6,,,,
16786,6,10,16,,,,
16316,6,8,14,,,,
14065,17,4,21,,,,
12234,24,0,24,,,,
6943,7,12,19,,,,
9387,16,40,56,,,,
14523,1,3,4,,,,
5355,33,192,225,,,,
175,492,8,500,,,,
8617,4,11,15,,,,
6655,52,22,74,,,,
15134,10,15,25,,,,
6169,28,10,38,,,,
5656,1,1,2,,,,
1497,7,2,9,,,,
9361,17,0,17,,,,
6822,5,6,11,,,,
2835,81,46,127,,,,
14011,1,6,7,,,,
5313,4,0,4,,,,
7673,3,1,4,,,,
7334,4,4,8,,,,
10470,43,25,68,,,,
8229,51,10,61,,,,
6484,12,62,74,,,,
9868,2,3,5,,,,
5411,17,175,192,,,,
3460,69,18,87,,,,
17189,1,1,2,,,,
17135,19,5,24,,,,
8313,39,0,39,,,,
15309,2,2,4,,,,
9921,14,1,15,,,,
15642,1,0,1,,,,
4405,9,6,15,,,,
4094,4,12,16,,,,
1931,13,102,115,,,,
13061,10,3,13,,,,
4843,2,6,8,,,,
9470,3,1,4,,,,
925,49,95,144,,,,
5066,6,13,19,,,,
6756,8,14,22,,,,
14171,6,62,68,,,,
6020,4,33,37,,,,
2592,3,3,6,,,,
2366,3,18,21,,,,
7963,5,45,50,,,,
12419,2,2,4,,,,
8964,46,78,124,,,,
2073,4,2,6,,,,
14927,15,6,21,,,,
3238,28,8,36,,,,
14261,2,3,5,,,,
10721,2,0,2,,,,
5467,182,39,221,,,,
2604,56,55,111,,,,
15183,2,7,9,,,,
14158,2,1,3,,,,
7497,1,7,8,,,,
13107,2,18,20,,,,
14903,6,5,11,,,,
8165,16,123,139,,,,
15058,11,4,15,,,,
6728,1,2,3,,,,
2909,5,36,41,,,,
3274,149,14,163,,,,
7859,19,1,20,,,,
4817,2,15,17,,,,
5804,9,1,10,,,,
6772,7,17,24,,,,
14533,1,0,1,,,,
8142,7,28,35,,,,
562,70,1,71,,,,
2535,5,12,17,,,,
5590,15,4,19,,,,
2041,2,6,8,,,,
7316,111,76,187,,,,
12158,2,3,5,,,,
2566,13,5,18,,,,
12441,12,40,52,,,,
14091,4,4,8,,,,
16191,3,13,16,,,,
12899,1,0,1,,,,
1237,10,2,12,,,,
5052,6,13,19,,,,
4444,3,0,3,,,,
8705,1,5,6,,,,
1729,31,50,81,,,,
11498,90,2,92,,,,
9216,2,2,4,,,,
14426,2,2,4,,,,
2952,4,1,5,,,,
7665,10,2,12,,,,
11140,6,0,6,,,,
8743,4,2,6,,,,
2968,7,28,35,,,,
8777,33,3,36,,,,
9393,4,0,4,,,,
11162,30,10,40,,,,
2296,3,56,59,,,,
4675,40,9,49,,,,
11507,16,31,47,,,,
5824,17,19,36,,,,
4595,19,7,26,,,,
7230,1,26,27,,,,
7093,1,0,1,,,,
13473,2,13,15,,,,
899,10,4,14,,,,
1852,22,85,107,,,,
9042,9,11,20,,,,
580,9,2,11,,,,
13710,1,8,9,,,,
1165,5,9,14,,,,
9258,13,2,15,,,,
16801,6,7,13,,,,
2849,12,14,26,,,,
13323,23,9,32,,,,
11441,11,10,21,,,,
6789,48,16,64,,,,
12064,9,15,24,,,,
11131,3,4,7,,,,
3419,10,18,28,,,,
1178,8,7,15,,,,
5450,47,34,81,,,,
8109,75,29,104,,,,
8787,78,5,83,,,,
17002,7,2,9,,,,
5101,15,37,52,,,,
13752,4,6,10,,,,
16400,6,9,15,,,,
13988,14,15,29,,,,
15596,9,4,13,,,,
4400,16,14,30,,,,
14282,15,12,27,,,,
13287,5,12,17,,,,
1522,15,2,17,,,,
6307,3,3,6,,,,
2991,1,17,18,,,,
2299,67,39,106,,,,
10119,5,18,23,,,,
12529,7,9,16,,,,
7195,7,35,42,,,,
16738,16,6,22,,,,
3818,5,5,10,,,,
8426,3,3,6,,,,
8829,12,0,12,,,,
11342,156,11,167,,,,
1691,58,55,113,,,,
7051,60,3,63,,,,
3693,7,14,21,,,,
16126,2,5,7,,,,
8937,12,8,20,,,,
11720,55,10,65,,,,
6487,3,2,5,,,,
13848,10,5,15,,,,
11750,16,0,16,,,,
15897,1,4,5,,,,
14181,19,40,59,,,,
7832,23,20,43,,,,
5546,16,13,29,,,,
4556,26,51,77,,,,
5239,4,25,29,,,,
15709,4,1,5,,,,
8568,11,7,18,,,,
5427,49,104,153,,,,
17042,7,6,13,,,,
17377,4,15,19,,,,
15128,35,10,45,,,,
12161,5,0,5,,,,
9313,4,21,25,,,,
12262,32,15,47,,,,
12484,2,6,8,,,,
1067,109,191,300,,,,
3469,7,45,52,,,,
4251,5,15,20,,,,
2234,11,11,22,,,,
4133,69,19,88,,,,
6069,39,36,75,,,,
2590,12,16,28,,,,
7982,8,5,13,,,,
11760,2,62,64,,,,
13875,27,0,27,,,,
17740,1,0,1,,,,
2831,19,3,22,,,,
4945,19,12,31,,,,
814,4,39,43,,,,
4663,13,31,44,,,,
13867,2,10,12,,,,
8714,1,17,18,,,,
16829,1,0,1,,,,
12757,2,10,12,,,,
12549,16,5,21,,,,
14960,55,34,89,,,,
14839,14,1,15,,,,
7748,10,6,16,,,,
9839,1,6,7,,,,
6650,10,14,24,,,,
13098,2,4,6,,,,
11071,14,15,29,,,,
9259,4,1,5,,,,
13609,4,23,27,,,,
6313,4,8,12,,,,
2816,8,12,20,,,,
13185,24,66,90,,,,
2764,54,11,65,,,,
2075,22,7,29,,,,
41,4,12,16,,,,
11796,2,11,13,,,,
6525,20,20,40,,,,
2735,25,25,50,,,,
3549,11,21,32,,,,
4991,1,2,3,,,,
9781,9,1,10,,,,
17361,6,2,8,,,,
5476,49,156,205,,,,
2815,12,4,16,,,,
11490,162,29,191,,,,
5256,34,28,62,,,,
7977,2,9,11,,,,
16343,21,13,34,,,,
4685,3,17,20,,,,
9888,5,6,11,,,,
6948,6,5,11,,,,
3751,1,5,6,,,,
7131,16,2,18,,,,
5888,9,44,53,,,,
3941,6,7,13,,,,
1301,74,46,120,,,,
651,37,48,85,,,,
12342,20,9,29,,,,
2666,9,73,82,,,,
249,28,0,28,,,,
16263,2,1,3,,,,
864,7,24,31,,,,
7189,7,67,74,,,,
14854,2,5,7,,,,
12265,2,10,12,,,,
12325,17,13,30,,,,
6830,3,1,4,,,,
11253,5,13,18,,,,
7851,6,19,25,,,,
9493,11,8,19,,,,
16762,2,2,4,,,,
6734,8,0,8,,,,
13617,1,7,8,,,,
8603,13,15,28,,,,
15106,8,1,9,,,,
9836,6,3,9,,,,
16566,2,3,5,,,,
9229,5,28,33,,,,
2982,22,14,36,,,,
7880,32,15,47,,,,
2251,48,23,71,,,,
17151,4,23,27,,,,
1841,21,2,23,,,,
585,7,8,15,,,,
163,36,427,463,,,,
1980,46,32,78,,,,
7704,1,5,6,,,,
6524,19,30,49,,,,
11958,8,20,28,,,,
3805,33,6,39,,,,
1547,2,1,3,,,,
14690,7,26,33,,,,
7725,6,19,25,,,,
412,57,82,139,,,,
5429,54,152,206,,,,
4009,16,49,65,,,,
5265,17,20,37,,,,
16292,11,0,11,,,,
3921,47,3,50,,,,
3891,18,10,28,,,,
11294,6,4,10,,,,
11367,2,1,3,,,,
9135,17,8,25,,,,
1017,19,32,51,,,,
55,2,0,2,,,,
13878,2,5,7,,,,
13258,4,4,8,,,,
13348,18,0,18,,,,
11455,1,1,2,,,,
4031,1,18,19,,,,
15620,3,12,15,,,,
13961,11,1,12,,,,
4361,42,7,49,,,,
9682,12,33,45,,,,
4246,2,2,4,,,,
17569,1,0,1,,,,
6214,57,69,126,,,,
10477,24,21,45,,,,
8423,1,2,3,,,,
4462,12,16,28,,,,
17778,0,2,2,,,,
9770,0,10,10,,,,
328,0,26,26,,,,
14108,0,30,30,,,,
1534,0,17,17,,,,
8827,0,11,11,,,,
5056,0,37,37,,,,
10231,0,5,5,,,,
10205,0,32,32,,,,
17779,0,11,11,,,,
12883,0,27,27,,,,
9536,0,5,5,,,,
9665,0,27,27,,,,
11076,0,4,4,,,,
15646,0,32,32,,,,
862,0,34,34,,,,
896,0,136,136,,,,
4338,0,5,5,,,,
5833,0,13,13,,,,
16571,0,6,6,,,,
8040,0,20,20,,,,
577,0,19,19,,,,
6353,0,15,15,,,,
10420,0,20,20,,,,
10426,0,10,10,,,,
9074,0,17,17,,,,
3361,0,153,153,,,,
9276,0,79,79,,,,
13226,0,29,29,,,,
13761,0,19,19,,,,
13178,0,91,91,,,,
16064,0,3,3,,,,
13428,0,12,12,,,,
11853,0,12,12,,,,
1380,0,39,39,,,,
4329,0,34,34,,,,
1400,0,53,53,,,,
2591,0,8,8,,,,
10398,0,27,27,,,,
392,0,46,46,,,,
2046,0,3,3,,,,
9350,0,39,39,,,,
17093,0,1,1,,,,
15995,0,61,61,,,,
16002,0,46,46,,,,
16055,0,39,39,,,,
5984,0,9,9,,,,
6634,0,11,11,,,,
10722,0,3,3,,,,
6876,0,45,45,,,,
5996,0,3,3,,,,
10746,0,26,26,,,,
854,0,12,12,,,,
7868,0,23,23,,,,
14721,0,29,29,,,,
7670,0,24,24,,,,
2750,0,15,15,,,,
7091,0,36,36,,,,
12415,0,10,10,,,,
860,0,37,37,,,,
15880,0,11,11,,,,
6832,0,16,16,,,,
13136,0,25,25,,,,
15450,0,15,15,,,,
5228,0,27,27,,,,
10827,0,41,41,,,,
4509,0,58,58,,,,
8335,0,32,32,,,,
2743,0,7,7,,,,
1426,0,38,38,,,,
16349,0,8,8,,,,
16358,0,11,11,,,,
16094,0,49,49,,,,
2879,0,85,85,,,,
5296,0,20,20,,,,
5249,0,13,13,,,,
2654,0,39,39,,,,
16816,0,4,4,,,,
6185,0,10,10,,,,
17417,0,5,5,,,,
8293,0,6,6,,,,
15285,0,12,12,,,,
5036,0,74,74,,,,
3258,0,34,34,,,,
8823,0,6,6,,,,
4993,0,6,6,,,,
14109,0,18,18,,,,
5160,0,2,2,,,,
4437,0,32,32,,,,
17032,0,57,57,,,,
2268,0,128,128,,,,
9842,0,205,205,,,,
582,0,6,6,,,,
8615,0,33,33,,,,
16655,0,5,5,,,,
2923,0,10,10,,,,
4840,0,26,26,,,,
3027,0,26,26,,,,
14326,0,6,6,,,,
2019,0,5,5,,,,
13993,0,23,23,,,,
7294,0,14,14,,,,
12849,0,20,20,,,,
17010,0,12,12,,,,
7277,0,104,104,,,,
5029,0,29,29,,,,
7236,0,20,20,,,,
11572,0,1,1,,,,
9474,0,2,2,,,,
8258,0,55,55,,,,
8219,0,51,51,,,,
1326,0,22,22,,,,
4732,0,37,37,,,,
4823,0,11,11,,,,
14166,0,13,13,,,,
8307,0,34,34,,,,
14152,0,9,9,,,,
14538,0,63,63,,,,
8659,0,10,10,,,,
16584,0,2,2,,,,
10255,0,5,5,,,,
15314,0,4,4,,,,
8842,0,1,1,,,,
3267,0,75,75,,,,
9308,0,5,5,,,,
2479,0,13,13,,,,
9614,0,58,58,,,,
13109,0,59,59,,,,
4554,0,74,74,,,,
11765,0,31,31,,,,
16725,0,9,9,,,,
16822,0,8,8,,,,
3053,0,16,16,,,,
13973,0,5,5,,,,
1230,0,9,9,,,,
15529,0,12,12,,,,
4435,0,27,27,,,,
15410,0,16,16,,,,
13313,0,5,5,,,,
7331,0,4,4,,,,
10481,0,34,34,,,,
4419,0,17,17,,,,
16293,0,8,8,,,,
3592,0,38,38,,,,
16726,0,16,16,,,,
13960,0,16,16,,,,
13934,0,30,30,,,,
16108,0,10,10,,,,
15492,0,48,48,,,,
4181,0,17,17,,,,
16471,0,18,18,,,,
5817,0,49,49,,,,
11213,0,19,19,,,,
12556,0,14,14,,,,
11208,0,49,49,,,,
14990,0,15,15,,,,
3600,0,11,11,,,,
16345,0,5,5,,,,
7324,0,9,9,,,,
2778,0,6,6,,,,
5688,0,6,6,,,,
7163,0,24,24,,,,
15658,0,13,13,,,,
961,0,13,13,,,,
947,0,14,14,,,,
9674,0,24,24,,,,
14654,0,6,6,,,,
15442,0,15,15,,,,
9803,0,11,11,,,,
4511,0,21,21,,,,
11278,0,5,5,,,,
4464,0,23,23,,,,
10856,0,10,10,,,,
594,0,6,6,,,,
15547,0,18,18,,,,
16623,0,5,5,,,,
1263,0,8,8,,,,
17524,0,7,7,,,,
7962,0,8,8,,,,
4832,0,6,6,,,,
5807,0,12,12,,,,
17423,0,4,4,,,,
15818,0,6,6,,,,
12527,0,16,16,,,,
9910,0,18,18,,,,
9482,0,10,10,,,,
8210,0,40,40,,,,
8245,0,22,22,,,,
7625,0,14,14,,,,
7626,0,14,14,,,,
8035,0,4,4,,,,
6619,0,28,28,,,,
10942,0,1,1,,,,
1130,0,2,2,,,,
10482,0,2,2,,,,
7804,0,15,15,,,,
13949,0,17,17,,,,
14134,0,10,10,,,,
2787,0,9,9,,,,
8887,0,4,4,,,,
8904,0,4,4,,,,
1192,0,80,80,,,,
16602,0,2,2,,,,
1382,0,38,38,,,,
3776,0,8,8,,,,
9238,0,2,2,,,,
17797,0,1,1,,,,
7757,0,7,7,,,,
10895,0,10,10,,,,
4899,0,9,9,,,,
17581,0,10,10,,,,
17497,0,7,7,,,,
6074,0,2,2,,,,
2087,0,6,6,,,,
8747,0,10,10,,,,
17027,0,7,7,,,,
6603,0,11,11,,,,
7013,0,7,7,,,,
10949,0,5,5,,,,
422,0,6,6,,,,
8810,0,7,7,,,,
3829,0,36,36,,,,
12180,0,9,9,,,,
10179,0,36,36,,,,
4469,0,26,26,,,,
12557,0,7,7,,,,
5918,0,14,14,,,,
11992,0,12,12,,,,
11984,0,15,15,,,,
11977,0,1,1,,,,
14242,0,2,2,,,,
4428,0,35,35,,,,
1448,0,97,97,,,,
1122,0,18,18,,,,
6940,0,23,23,,,,
9628,0,13,13,,,,
8847,0,6,6,,,,
13264,0,25,25,,,,
15234,0,11,11,,,,
11083,0,15,15,,,,
17143,0,5,5,,,,
7369,0,9,9,,,,
786,0,63,63,,,,
16269,0,3,3,,,,
13020,0,4,4,,,,
1090,0,22,22,,,,
5771,0,8,8,,,,
17407,0,10,10,,,,
8352,0,24,24,,,,
11037,0,32,32,,,,
13794,0,7,7,,,,
15700,0,22,22,,,,
10555,0,47,47,,,,
10533,0,56,56,,,,
4806,0,74,74,,,,
5192,0,13,13,,,,
6053,0,3,3,,,,
14477,0,8,8,,,,
8670,0,5,5,,,,
9480,0,9,9,,,,
8650,0,5,5,,,,
7855,0,7,7,,,,
10622,0,25,25,,,,
14635,0,16,16,,,,
11975,0,9,9,,,,
3780,0,2,2,,,,
5532,0,3,3,,,,
4642,0,16,16,,,,
14165,0,40,40,,,,
5552,0,25,25,,,,
1857,0,28,28,,,,
8304,0,28,28,,,,
1656,0,9,9,,,,
15719,0,5,5,,,,
12751,0,10,10,,,,
3294,0,60,60,,,,
16629,0,16,16,,,,
7536,0,36,36,,,,
11889,0,15,15,,,,
15091,0,9,9,,,,
6427,0,14,14,,,,
2635,0,44,44,,,,
9006,0,10,10,,,,
8727,0,4,4,,,,
1000,0,9,9,,,,
5100,0,10,10,,,,
8610,0,12,12,,,,
12775,0,10,10,,,,
5006,0,8,8,,,,
1454,0,8,8,,,,
12340,0,18,18,,,,
17146,0,8,8,,,,
16328,0,21,21,,,,
17698,0,5,5,,,,
4866,0,12,12,,,,
3552,0,4,4,,,,
8119,0,3,3,,,,
16748,0,6,6,,,,
17770,0,3,3,,,,
16960,0,3,3,,,,
9156,0,6,6,,,,
15688,0,23,23,,,,
3158,0,18,18,,,,
15136,0,20,20,,,,
2190,0,9,9,,,,
11591,0,29,29,,,,
1584,0,44,44,,,,
975,0,19,19,,,,
13305,0,4,4,,,,
4671,0,49,49,,,,
4670,0,37,37,,,,
994,0,3,3,,,,
8685,0,21,21,,,,
17296,0,11,11,,,,
17642,0,4,4,,,,
2037,0,3,3,,,,
15784,0,22,22,,,,
5963,0,2,2,,,,
7357,0,7,7,,,,
11578,0,10,10,,,,
16495,0,1,1,,,,
8676,0,33,33,,,,
8147,0,28,28,,,,
10394,0,1,1,,,,
9358,0,4,4,,,,
7690,0,4,4,,,,
15339,0,4,4,,,,
6375,0,2,2,,,,
13095,0,6,6,,,,
15064,0,8,8,,,,
7395,0,1,1,,,,
13471,0,19,19,,,,
12604,0,12,12,,,,
13598,0,8,8,,,,
13067,0,11,11,,,,
16832,0,6,6,,,,
13980,0,9,9,,,,
15097,0,17,17,,,,
2985,0,15,15,,,,
2185,0,37,37,,,,
2167,0,34,34,,,,
17193,0,7,7,,,,
8880,0,5,5,,,,
12121,0,10,10,,,,
15907,0,3,3,,,,
4949,0,16,16,,,,
9428,0,7,7,,,,
2094,0,4,4,,,,
4125,0,24,24,,,,
15984,0,17,17,,,,
2890,0,46,46,,,,
218,0,11,11,,,,
17637,0,3,3,,,,
16122,0,10,10,,,,
9453,0,2,2,,,,
9417,0,54,54,,,,
2038,0,3,3,,,,
6828,0,1,1,,,,
5002,0,18,18,,,,
5550,0,43,43,,,,
9448,0,7,7,,,,
15778,0,12,12,,,,
16392,0,7,7,,,,
4841,0,5,5,,,,
10892,0,17,17,,,,
567,0,10,10,,,,
10170,0,7,7,,,,
15147,0,13,13,,,,
11910,0,15,15,,,,
16185,0,18,18,,,,
12374,0,7,7,,,,
17266,0,8,8,,,,
8416,0,7,7,,,,
16226,0,1,1,,,,
2109,0,2,2,,,,
7265,0,5,5,,,,
16694,0,18,18,,,,
38,0,19,19,,,,
15302,0,21,21,,,,
14588,0,9,9,,,,
995,0,10,10,,,,
16653,0,6,6,,,,
12756,0,13,13,,,,
7698,0,20,20,,,,
4557,0,24,24,,,,
12055,0,14,14,,,,
7202,0,4,4,,,,
3536,0,15,15,,,,
16700,0,4,4,,,,
12327,0,6,6,,,,
16667,0,7,7,,,,
5176,0,11,11,,,,
16035,0,6,6,,,,
8039,0,9,9,,,,
10130,0,2,2,,,,
8725,0,6,6,,,,
7443,0,6,6,,,,
7966,0,9,9,,,,
11474,0,5,5,,,,
6006,0,10,10,,,,
13649,0,1,1,,,,
12098,0,2,2,,,,
10217,0,4,4,,,,
17754,0,2,2,,,,
17466,0,3,3,,,,
7196,0,6,6,,,,
11008,0,2,2,,,,
13864,0,14,14,,,,
11171,0,8,8,,,,
3056,0,22,22,,,,
5923,0,6,6,,,,
9760,0,11,11,,,,
6989,0,1,1,,,,
14652,0,6,6,,,,
2539,0,15,15,,,,
12552,0,5,5,,,,
9194,0,23,23,,,,
5093,0,35,35,,,,
424,0,4,4,,,,
17639,0,14,14,,,,
12522,0,3,3,,,,
9407,0,10,10,,,,
14826,0,20,20,,,,
17699,0,6,6,,,,
14156,0,6,6,,,,
8518,0,32,32,,,,
8753,0,8,8,,,,
6988,0,12,12,,,,
15744,0,1,1,,,,
3327,0,7,7,,,,
14430,0,8,8,,,,
5102,0,29,29,,,,
6929,0,29,29,,,,
13869,0,7,7,,,,
15175,0,16,16,,,,
4174,0,21,21,,,,
5179,0,6,6,,,,
15900,0,14,14,,,,
10277,0,1,1,,,,
15137,0,11,11,,,,
11630,0,21,21,,,,
1085,0,16,16,,,,
17749,0,2,2,,,,
9050,0,7,7,,,,
11645,0,21,21,,,,
10992,0,10,10,,,,
15254,0,5,5,,,,
15668,0,9,9,,,,
16132,0,10,10,,,,
17503,0,4,4,,,,
8104,0,2,2,,,,
4971,0,5,5,,,,
5743,0,6,6,,,,
15063,0,10,10,,,,
6885,0,11,11,,,,
3879,0,34,34,,,,
2681,0,18,18,,,,
6518,0,2,2,,,,
14599,0,14,14,,,,
12882,0,10,10,,,,
1364,0,9,9,,,,
7387,0,12,12,,,,
15535,0,3,3,,,,
14577,0,25,25,,,,
15581,0,6,6,,,,
9738,0,11,11,,,,
2162,0,9,9,,,,
14624,0,8,8,,,,
8071,0,12,12,,,,
16492,0,1,1,,,,
11448,0,3,3,,,,
3466,0,31,31,,,,
13284,0,2,2,,,,
15634,0,9,9,,,,
13464,0,20,20,,,,
2049,0,2,2,,,,
14659,0,9,9,,,,
12172,0,6,6,,,,
13419,0,12,12,,,,
15951,0,1,1,,,,
4253,0,12,12,,,,
5292,0,19,19,,,,
15571,0,1,1,,,,
14095,0,7,7,,,,
15333,0,2,2,,,,
8341,0,4,4,,,,
7530,0,34,34,,,,
9010,0,50,50,,,,
12943,0,4,4,,,,
3553,0,2,2,,,,
3443,0,5,5,,,,
8072,0,19,19,,,,
15542,0,4,4,,,,
7389,0,11,11,,,,
17341,0,13,13,,,,
9146,0,9,9,,,,
4401,0,8,8,,,,
17297,0,7,7,,,,
8298,0,3,3,,,,
12795,0,11,11,,,,
8846,0,2,2,,,,
3315,0,4,4,,,,
14795,0,7,7,,,,
9684,0,20,20,,,,
12057,0,29,29,,,,
16599,0,6,6,,,,
7654,0,20,20,,,,
8552,0,9,9,,,,
8217,0,7,7,,,,
13300,0,8,8,,,,
11438,0,19,19,,,,
16221,0,3,3,,,,
12697,0,6,6,,,,
11191,0,30,30,,,,
11031,0,9,9,,,,
2734,0,11,11,,,,
9913,0,6,6,,,,
15497,0,22,22,,,,
11093,0,8,8,,,,
12742,0,11,11,,,,
5087,0,8,8,,,,
3768,0,21,21,,,,
17460,0,7,7,,,,
16932,0,20,20,,,,
16525,0,1,1,,,,
8108,0,3,3,,,,
12579,0,10,10,,,,
15574,0,22,22,,,,
12076,0,11,11,,,,
17684,0,8,8,,,,
7201,0,5,5,,,,
15184,0,5,5,,,,
3819,0,4,4,,,,
17140,0,2,2,,,,
15256,0,2,2,,,,
4491,0,23,23,,,,
14192,0,24,24,,,,
8635,0,10,10,,,,
17240,0,3,3,,,,
2250,0,8,8,,,,
16658,0,3,3,,,,
6996,0,10,10,,,,
17597,0,9,9,,,,
13921,0,6,6,,,,
17243,0,3,3,,,,
15734,0,15,15,,,,
12807,0,11,11,,,,
5097,0,3,3,,,,
10988,0,26,26,,,,
13637,0,6,6,,,,
11856,0,6,6,,,,
7054,0,11,11,,,,
17669,0,4,4,,,,
13352,0,3,3,,,,
635,0,8,8,,,,
10407,0,6,6,,,,
9580,0,5,5,,,,
15443,0,3,3,,,,
16949,0,11,11,,,,
938,0,10,10,,,,
7601,0,24,24,,,,
6896,0,18,18,,,,
3817,0,4,4,,,,
17400,0,8,8,,,,
7282,0,12,12,,,,
3115,0,4,4,,,,
15197,0,2,2,,,,
6534,0,12,12,,,,
15582,0,7,7,,,,
14113,0,5,5,,,,
2125,0,7,7,,,,
8465,0,12,12,,,,
16876,0,4,4,,,,
17566,0,4,4,,,,
16970,0,15,15,,,,
17369,0,13,13,,,,
16990,0,3,3,,,,
17416,0,12,12,,,,
15035,0,13,13,,,,
14663,0,4,4,,,,
36,0,13,13,,,,
9320,0,10,10,,,,
11357,0,5,5,,,,
14018,0,4,4,,,,
7133,0,18,18,,,,
8696,0,4,4,,,,
9976,0,13,13,,,,
10247,0,6,6,,,,
5655,0,3,3,,,,
10296,0,2,2,,,,
10246,0,1,1,,,,
10752,0,10,10,,,,
8393,0,4,4,,,,
16508,0,4,4,,,,
16891,0,10,10,,,,
8848,0,4,4,,,,
15174,0,21,21,,,,
6165,0,5,5,,,,
12120,0,22,22,,,,
13985,0,6,6,,,,
10161,0,4,4,,,,
3449,0,6,6,,,,
8711,0,6,6,,,,
10250,0,3,3,,,,
8849,0,8,8,,,,
7689,0,10,10,,,,
13298,0,6,6,,,,
9289,0,5,5,,,,
13309,0,3,3,,,,
16144,0,5,5,,,,
7263,0,3,3,,,,
17476,0,4,4,,,,
15446,0,19,19,,,,
15807,0,7,7,,,,
6367,0,1,1,,,,
10868,0,8,8,,,,
17102,0,3,3,,,,
14509,0,6,6,,,,
1286,0,1,1,,,,
4515,0,14,14,,,,
17179,0,8,8,,,,
17604,0,6,6,,,,
3135,0,22,22,,,,
9245,0,11,11,,,,
636,0,10,10,,,,
11284,0,10,10,,,,
13319,0,15,15,,,,
11793,0,7,7,,,,
12267,0,9,9,,,,
16329,0,3,3,,,,
12045,0,11,11,,,,
12069,0,22,22,,,,
12690,0,8,8,,,,
9458,0,2,2,,,,
9987,0,10,10,,,,
6548,0,11,11,,,,
16957,0,4,4,,,,
9095,0,4,4,,,,
16871,0,3,3,,,,
1268,0,8,8,,,,
16213,0,6,6,,,,
15680,0,26,26,,,,
8316,0,1,1,,,,
9209,0,8,8,,,,
2789,0,11,11,,,,
16714,0,2,2,,,,
9636,0,11,11,,,,
13811,0,14,14,,,,
16778,0,5,5,,,,
7451,0,5,5,,,,
13378,0,4,4,,,,
7204,0,6,6,,,,
10572,0,4,4,,,,
17553,0,6,6,,,,
8896,0,7,7,,,,
7724,0,8,8,,,,
17158,0,10,10,,,,
17406,0,1,1,,,,
16619,0,13,13,,,,
14333,0,5,5,,,,
17367,0,3,3,,,,
15209,0,6,6,,,,
13737,0,12,12,,,,
16950,0,11,11,,,,
15922,0,12,12,,,,
8707,0,14,14,,,,
11469,0,5,5,,,,
8733,0,9,9,,,,
8710,0,6,6,,,,
15763,0,25,25,,,,
12147,0,10,10,,,,
9890,0,19,19,,,,
597,0,5,5,,,,
15537,0,3,3,,,,
15885,0,5,5,,,,
17535,0,1,1,,,,
1240,0,8,8,,,,
4891,0,7,7,,,,
12630,0,2,2,,,,
13842,0,2,2,,,,
2930,0,20,20,,,,
13140,0,6,6,,,,
17213,0,9,9,,,,
11207,0,17,17,,,,
12261,0,8,8,,,,
16403,0,5,5,,,,
17813,0,3,3,,,,
4138,0,3,3,,,,
16406,0,4,4,,,,
3207,0,7,7,,,,
17410,0,1,1,,,,
16336,0,9,9,,,,
6120,0,30,30,,,,
4610,0,6,6,,,,
5986,0,18,18,,,,
4636,0,10,10,,,,
7980,0,3,3,,,,
17250,0,1,1,,,,
10591,0,6,6,,,,
3709,0,4,4,,,,
14793,0,11,11,,,,
8361,0,4,4,,,,
17187,0,6,6,,,,
6846,0,16,16,,,,
11355,0,4,4,,,,
8682,0,6,6,,,,
13733,0,17,17,,,,
14816,0,5,5,,,,
14087,0,2,2,,,,
16679,0,3,3,,,,
16849,0,6,6,,,,
2244,0,15,15,,,,
6360,0,6,6,,,,
9872,0,35,35,,,,
17114,0,3,3,,,,
15426,0,10,10,,,,
14708,0,4,4,,,,
16580,0,4,4,,,,
10859,0,7,7,,,,
1444,0,9,9,,,,
8463,0,1,1,,,,
14809,0,15,15,,,,
10380,0,17,17,,,,
2082,0,5,5,,,,
13321,0,7,7,,,,
8490,0,7,7,,,,
16936,0,4,4,,,,
12414,0,8,8,,,,
17277,0,14,14,,,,
14767,0,10,10,,,,
11104,0,12,12,,,,
17082,0,10,10,,,,
17418,0,4,4,,,,
13374,0,9,9,,,,
17586,0,11,11,,,,
17588,0,7,7,,,,
10335,0,2,2,,,,
5618,0,7,7,,,,
10168,0,6,6,,,,
3145,0,12,12,,,,
8462,0,7,7,,,,
15811,0,4,4,,,,
17656,0,3,3,,,,
17310,0,8,8,,,,
17239,0,5,5,,,,
17653,0,4,4,,,,
5637,0,10,10,,,,
4838,0,3,3,,,,
17215,0,2,2,,,,
15884,0,4,4,,,,
12673,0,2,2,,,,
14848,0,1,1,,,,
15509,0,3,3,,,,
6937,0,25,25,,,,
3983,0,20,20,,,,
9745,0,7,7,,,,
10276,0,7,7,,,,
5761,0,2,2,,,,
3547,0,6,6,,,,
13812,0,15,15,,,,
16277,0,11,11,,,,
10438,0,15,15,,,,
6606,0,8,8,,,,
11223,0,9,9,,,,
13894,0,4,4,,,,
17576,0,5,5,,,,
14040,0,6,6,,,,
9347,0,13,13,,,,
7933,0,4,4,,,,
10262,0,10,10,,,,
1197,0,3,3,,,,
15925,0,2,2,,,,
9911,0,8,8,,,,
1175,0,4,4,,,,
12601,0,7,7,,,,
10648,0,1,1,,,,
8238,0,11,11,,,,
11906,0,20,20,,,,
7792,0,1,1,,,,
7937,0,1,1,,,,
12707,0,10,10,,,,
11843,0,5,5,,,,
16975,0,9,9,,,,
17850,0,2,2,,,,
15160,0,3,3,,,,
7245,0,4,4,,,,
17137,0,12,12,,,,
13400,0,6,6,,,,
14806,0,11,11,,,,
16135,0,3,3,,,,
13916,0,12,12,,,,
13438,0,5,5,,,,
15693,0,1,1,,,,
13643,0,4,4,,,,
16947,0,4,4,,,,
17370,0,7,7,,,,
17368,0,4,4,,,,
13376,0,8,8,,,,
13437,0,12,12,,,,
12103,0,6,6,,,,
4433,0,18,18,,,,
15852,0,8,8,,,,
11596,0,2,2,,,,
3001,0,9,9,,,,
7728,0,3,3,,,,
3137,0,6,6,,,,
11461,0,2,2,,,,
17529,0,9,9,,,,
7510,0,17,17,,,,
12115,0,7,7,,,,
6651,0,12,12,,,,
16859,0,14,14,,,,
16649,0,3,3,,,,
5697,0,2,2,,,,
17805,0,3,3,,,,
3436,0,17,17,,,,
14863,0,2,2,,,,
3385,0,17,17,,,,
12829,0,6,6,,,,
17290,0,6,6,,,,
9810,0,22,22,,,,
3517,0,15,15,,,,
11827,0,5,5,,,,
17409,0,1,1,,,,
7454,0,3,3,,,,
11604,0,2,2,,,,
13884,0,17,17,,,,
1233,0,5,5,,,,
14280,0,7,7,,,,
12382,0,5,5,,,,
16944,0,7,7,,,,
5120,0,3,3,,,,
9983,0,5,5,,,,
11209,0,3,3,,,,
584,0,7,7,,,,
3609,0,4,4,,,,
13610,0,14,14,,,,
2537,0,9,9,,,,
11849,0,8,8,,,,
11861,0,2,2,,,,
6553,0,4,4,,,,
4924,0,2,2,,,,
11358,0,14,14,,,,
16601,0,7,7,,,,
16285,0,6,6,,,,
4121,0,17,17,,,,
10328,0,10,10,,,,
14013,0,14,14,,,,
3138,0,1,1,,,,
11533,0,10,10,,,,
16450,0,9,9,,,,
8056,0,11,11,,,,
6086,0,2,2,,,,
10542,0,7,7,,,,
2012,0,5,5,,,,
11887,0,14,14,,,,
4652,0,5,5,,,,
4630,0,9,9,,,,
7055,0,12,12,,,,
17492,0,3,3,,,,
6719,0,12,12,,,,
10078,0,13,13,,,,
17848,0,1,1,,,,
10836,0,3,3,,,,
9835,0,4,4,,,,
1277,0,2,2,,,,
5767,0,8,8,,,,
7330,0,6,6,,,,
14320,0,4,4,,,,
9459,0,6,6,,,,
12246,0,5,5,,,,
11013,0,5,5,,,,
1225,0,4,4,,,,
6349,0,13,13,,,,
16869,0,2,2,,,,
6732,0,13,13,,,,
7643,0,4,4,,,,
15080,0,8,8,,,,
5529,0,5,5,,,,
4831,0,6,6,,,,
436,0,6,6,,,,
15345,0,5,5,,,,
14327,0,4,4,,,,
17650,0,2,2,,,,
10975,0,1,1,,,,
16741,0,3,3,,,,
9667,0,8,8,,,,
4638,0,3,3,,,,
2552,0,10,10,,,,
11172,0,6,6,,,,
15877,0,3,3,,,,
16113,0,13,13,,,,
13048,0,2,2,,,,
7476,0,19,19,,,,
17635,0,1,1,,,,
10972,0,7,7,,,,
16472,0,9,9,,,,
16590,0,9,9,,,,
1254,0,2,2,,,,
11145,0,6,6,,,,
2088,0,11,11,,,,
2572,0,4,4,,,,
7449,0,1,1,,,,
2130,0,1,1,,,,
11536,0,7,7,,,,
869,0,14,14,,,,
15089,0,8,8,,,,
8358,0,6,6,,,,
10660,0,20,20,,,,
8888,0,10,10,,,,
16814,0,3,3,,,,
9471,0,4,4,,,,
16864,0,4,4,,,,
16702,0,3,3,,,,
16796,0,3,3,,,,
7280,0,4,4,,,,
11010,0,3,3,,,,
7347,0,5,5,,,,
15747,0,1,1,,,,
4363,0,17,17,,,,
322,0,3,3,,,,
15001,0,14,14,,,,
1749,0,3,3,,,,
3589,0,3,3,,,,
8460,0,3,3,,,,
612,0,7,7,,,,
9427,0,3,3,,,,
12389,0,3,3,,,,
10619,0,3,3,,,,
2095,0,2,2,,,,
12157,0,7,7,,,,
15873,0,7,7,,,,
1105,0,4,4,,,,
4064,0,12,12,,,,
7246,0,2,2,,,,
12144,0,5,5,,,,
10413,0,3,3,,,,
2711,0,3,3,,,,
10824,0,1,1,,,,
17194,0,5,5,,,,
16606,0,1,1,,,,
14163,0,3,3,,,,
15371,0,13,13,,,,
11196,0,3,3,,,,
12567,0,9,9,,,,
6595,0,3,3,,,,
16736,0,2,2,,,,
16378,0,6,6,,,,
15980,0,5,5,,,,
7752,0,3,3,,,,
7753,0,4,4,,,,
8693,0,3,3,,,,
15343,0,3,3,,,,
16382,0,3,3,,,,
17851,0,2,2,,,,
8990,0,20,20,,,,
15694,0,3,3,,,,
12986,0,6,6,,,,
1220,0,8,8,,,,
17557,0,14,14,,,,
14997,0,5,5,,,,
12913,0,3,3,,,,
1471,0,5,5,,,,
15099,0,10,10,,,,
10599,0,7,7,,,,
9904,0,11,11,,,,
12728,0,10,10,,,,
11873,0,5,5,,,,
15186,0,1,1,,,,
7050,0,4,4,,,,
14349,0,5,5,,,,
14452,0,23,23,,,,
11754,0,6,6,,,,
10305,0,4,4,,,,
1168,0,14,14,,,,
8065,0,8,8,,,,
5956,0,7,7,,,,
7103,0,1,1,,,,
10742,0,14,14,,,,
17200,0,1,1,,,,
15142,0,2,2,,,,
3640,0,1,1,,,,
7875,0,10,10,,,,
15836,0,2,2,,,,
10144,0,4,4,,,,
15677,0,4,4,,,,
4266,0,5,5,,,,
14726,0,8,8,,,,
8183,0,4,4,,,,
3642,0,6,6,,,,
9484,0,7,7,,,,
15933,0,1,1,,,,
11541,0,5,5,,,,
2659,0,5,5,,,,
12173,0,2,2,,,,
16288,0,9,9,,,,
16247,0,2,2,,,,
3392,0,12,12,,,,
7718,0,2,2,,,,
9491,0,4,4,,,,
13612,0,3,3,,,,
15856,0,8,8,,,,
7610,0,10,10,,,,
14858,0,1,1,,,,
7448,0,9,9,,,,
16479,0,3,3,,,,
12041,0,2,2,,,,
5989,0,2,2,,,,
16364,0,3,3,,,,
11133,0,2,2,,,,
7322,0,9,9,,,,
16408,0,1,1,,,,
12964,0,3,3,,,,
10998,0,8,8,,,,
1140,0,9,9,,,,
14086,0,8,8,,,,
13134,0,2,2,,,,
9706,0,2,2,,,,
7216,0,9,9,,,,
1096,0,19,19,,,,
17237,0,4,4,,,,
4149,0,4,4,,,,
4178,0,5,5,,,,
2031,0,2,2,,,,
13457,0,15,15,,,,
1202,0,2,2,,,,
15452,0,9,9,,,,
10863,0,3,3,,,,
10011,0,2,2,,,,
10235,0,2,2,,,,
14493,0,2,2,,,,
9224,0,11,11,,,,
12735,0,6,6,,,,
3113,0,4,4,,,,
14448,0,4,4,,,,
8755,0,7,7,,,,
3416,0,3,3,,,,
3151,0,1,1,,,,
4893,0,9,9,,,,
13838,0,2,2,,,,
12994,0,4,4,,,,
1094,0,3,3,,,,
10841,0,9,9,,,,
10946,0,2,2,,,,
12388,0,8,8,,,,
3588,0,1,1,,,,
13083,0,5,5,,,,
14511,0,8,8,,,,
16893,0,12,12,,,,
4958,0,8,8,,,,
5685,0,2,2,,,,
8357,0,2,2,,,,
10233,0,6,6,,,,
8902,0,1,1,,,,
2420,0,7,7,,,,
13828,0,1,1,,,,
11427,0,6,6,,,,
13581,0,1,1,,,,
13582,0,1,1,,,,
11370,0,3,3,,,,
12201,0,2,2,,,,
17747,0,3,3,,,,
15489,0,12,12,,,,
17513,0,8,8,,,,
10273,0,8,8,,,,
6384,0,5,5,,,,
6611,0,6,6,,,,
507,0,7,7,,,,
16279,0,1,1,,,,
13790,0,1,1,,,,
2099,0,3,3,,,,
10849,0,6,6,,,,
15261,0,3,3,,,,
10150,0,1,1,,,,
14400,0,1,1,,,,
2797,0,3,3,,,,
4596,0,6,6,,,,
1453,0,12,12,,,,
10102,0,2,2,,,,
13586,0,5,5,,,,
3507,0,4,4,,,,
17375,0,3,3,,,,
17768,0,5,5,,,,
17591,0,9,9,,,,
15894,0,2,2,,,,
10870,0,10,10,,,,
11828,0,6,6,,,,
4425,0,5,5,,,,
7440,0,2,2,,,,
17045,0,7,7,,,,
5665,0,5,5,,,,
14230,0,8,8,,,,
7981,0,7,7,,,,
17546,0,3,3,,,,
15437,0,3,3,,,,
15577,0,2,2,,,,
7326,0,9,9,,,,
13802,0,1,1,,,,
12162,0,1,1,,,,
1456,0,5,5,,,,
16648,0,3,3,,,,
17884,0,1,1,,,,
1259,0,2,2,,,,
14506,0,3,3,,,,
17750,0,1,1,,,,
17752,0,2,2,,,,
14762,0,2,2,,,,
15076,0,3,3,,,,
8098,0,1,1,,,,
11931,0,9,9,,,,
7279,0,4,4,,,,
11991,0,2,2,,,,
12872,0,2,2,,,,
12777,0,6,6,,,,
15215,0,9,9,,,,
3822,0,1,1,,,,
15125,0,4,4,,,,
11122,0,3,3,,,,
17663,0,2,2,,,,
17911,0,1,1,,,,
6604,0,10,10,,,,
5094,0,5,5,,,,
12949,0,2,2,,,,
16823,0,7,7,,,,
17869,0,3,3,,,,
13666,0,7,7,,,,
8745,0,4,4,,,,
8897,0,5,5,,,,
6707,0,3,3,,,,
17708,0,1,1,,,,
10084,0,1,1,,,,
470,0,4,4,,,,
10363,0,3,3,,,,
17842,0,1,1,,,,
9777,0,12,12,,,,
16072,0,1,1,,,,
12699,0,5,5,,,,
14250,0,1,1,,,,
10551,0,7,7,,,,
17672,0,3,3,,,,
17856,0,2,2,,,,
7428,0,4,4,,,,
10925,0,2,2,,,,
15445,0,7,7,,,,
9773,0,4,4,,,,
17070,0,2,2,,,,
16659,0,12,12,,,,
10391,0,3,3,,,,
3222,0,2,2,,,,
17007,0,2,2,,,,
15226,0,1,1,,,,
9748,0,4,4,,,,
12784,0,5,5,,,,
6998,0,8,8,,,,
17847,0,1,1,,,,
16296,0,2,2,,,,
15277,0,2,2,,,,
4384,0,2,2,,,,
17737,0,1,1,,,,
15962,0,3,3,,,,
3626,0,3,3,,,,
12137,0,5,5,,,,
9741,0,8,8,,,,
10449,0,3,3,,,,
12592,0,1,1,,,,
13128,0,1,1,,,,
5718,0,1,1,,,,
7606,0,3,3,,,,
16468,0,2,2,,,,
2265,0,10,10,,,,
16491,0,2,2,,,,
12955,0,6,6,,,,
17877,0,3,3,,,,
3593,0,5,5,,,,
17371,0,3,3,,,,
15331,0,2,2,,,,
777,0,3,3,,,,
3568,0,2,2,,,,
11559,0,2,2,,,,
11452,0,1,1,,,,
13379,0,2,2,,,,
15213,0,4,4,,,,
17014,0,4,4,,,,
14440,0,1,1,,,,
17872,0,3,3,,,,
12399,0,2,2,,,,
15860,0,2,2,,,,
16230,0,3,3,,,,
7307,0,5,5,,,,
3430,0,2,2,,,,
10268,0,1,1,,,,
16409,0,5,5,,,,
12199,0,2,2,,,,
15990,0,3,3,,,,
11804,0,6,6,,,,
6316,0,3,3,,,,
1250,0,1,1,,,,
16250,0,1,1,,,,
15465,0,2,2,,,,
17901,0,1,1,,,,
5982,0,1,1,,,,
13125,0,1,1,,,,
5708,0,4,4,,,,
6383,0,1,1,,,,
17518,0,2,2,,,,
17425,0,1,1,,,,
16181,0,4,4,,,,
4825,0,3,3,,,,
1183,0,4,4,,,,
8077,0,3,3,,,,
14080,0,2,2,,,,
5947,0,1,1,,,,
17764,0,2,2,,,,
9465,0,4,4,,,,
6455,0,6,6,,,,
17865,0,1,1,,,,
621,0,2,2,,,,
16758,0,3,3,,,,
11872,0,3,3,,,,
14476,0,3,3,,,,
16943,0,1,1,,,,
2112,0,4,4,,,,
4048,0,2,2,,,,
17774,0,2,2,,,,
16916,0,1,1,,,,
13504,0,2,2,,,,
16524,0,3,3,,,,
6608,0,2,2,,,,
225,0,4,4,,,,
2145,0,5,5,,,,
16533,0,6,6,,,,
13618,0,3,3,,,,
17196,0,1,1,,,,
4981,0,1,1,,,,
469,0,1,1,,,,
1462,0,1,1,,,,
10663,0,4,4,,,,
10582,0,5,5,,,,
13435,0,1,1,,,,
15487,0,2,2,,,,
7021,0,4,4,,,,
17881,0,2,2,,,,
11157,0,2,2,,,,
17495,0,2,2,,,,
16784,0,2,2,,,,
16337,0,4,4,,,,
6541,0,2,2,,,,
17309,0,2,2,,,,
17139,0,1,1,,,,
17359,0,4,4,,,,
15221,0,1,1,,,,
12276,0,3,3,,,,
16069,0,1,1,,,,
5809,0,2,2,,,,
449,0,1,1,,,,
10308,0,2,2,,,,
11285,0,4,4,,,,
4396,0,5,5,,,,
4157,0,2,2,,,,
2057,0,1,1,,,,
8390,0,2,2,,,,
13590,0,2,2,,,,
17820,0,1,1,,,,
12844,0,2,2,,,,
14330,0,6,6,,,,
13930,0,7,7,,,,
3715,0,7,7,,,,
37,0,2,2,,,,
13289,0,4,4,,,,
17174,0,2,2,,,,
15773,0,1,1,,,,
16956,0,3,3,,,,
9401,0,1,1,,,,
2011,0,4,4,,,,
16567,0,1,1,,,,
12166,0,3,3,,,,
12506,0,2,2,,,,
9214,0,5,5,,,,
7913,0,2,2,,,,
14583,0,2,2,,,,
17808,0,2,2,,,,
8496,0,3,3,,,,
6587,0,1,1,,,,
16363,0,2,2,,,,
10589,0,1,1,,,,
17717,0,2,2,,,,
16238,0,2,2,,,,
8410,0,1,1,,,,
16682,0,4,4,,,,
12124,0,2,2,,,,
1013,0,3,3,,,,
6954,0,4,4,,,,
5133,0,7,7,,,,
17791,0,2,2,,,,
11564,0,2,2,,,,
7713,0,1,1,,,,
4978,0,2,2,,,,
13082,0,1,1,,,,
5486,0,2,2,,,,
17385,0,2,2,,,,
16272,0,1,1,,,,
8346,0,1,1,,,,
10689,0,2,2,,,,
10317,0,2,2,,,,
13604,0,2,2,,,,
7459,0,2,2,,,,
16509,0,2,2,,,,
11539,0,4,4,,,,
1461,0,1,1,,,,
11753,0,1,1,,,,
6609,0,3,3,,,,
16923,0,4,4,,,,
13395,0,2,2,,,,
8623,0,7,7,,,,
16812,0,3,3,,,,
13145,0,4,4,,,,
13294,0,2,2,,,,
13292,0,1,1,,,,
2586,0,9,9,,,,
10691,0,1,1,,,,
14778,0,6,6,,,,
17244,0,2,2,,,,
3015,0,3,3,,,,
1544,0,1,1,,,,
13450,0,2,2,,,,
12383,0,3,3,,,,
7108,0,5,5,,,,
10360,0,4,4,,,,
17618,0,1,1,,,,
12089,0,2,2,,,,
473,0,1,1,,,,
4049,0,1,1,,,,
11580,0,2,2,,,,
12839,0,2,2,,,,
14745,0,1,1,,,,
8344,0,1,1,,,,
9176,0,1,1,,,,
13804,0,2,2,,,,
13144,0,3,3,,,,
12693,0,1,1,,,,
14295,0,2,2,,,,
4239,0,1,1,,,,
17910,0,1,1,,,,
8505,0,2,2,,,,
16460,0,4,4,,,,
14494,0,2,2,,,,
17758,0,2,2,,,,
13967,0,1,1,,,,
7355,0,1,1,,,,
2763,0,1,1,,,,
10709,0,2,2,,,,
16223,0,3,3,,,,
14930,0,1,1,,,,
12890,0,2,2,,,,
17841,0,1,1,,,,
5531,0,2,2,,,,
17855,0,1,1,,,,
14637,0,1,1,,,,
17834,0,1,1,,,,
8100,0,1,1,,,,
17801,0,1,1,,,,
15293,0,3,3,,,,
14099,0,2,2,,,,
17477,0,1,1,,,,
5490,0,1,1,,,,
6979,0,1,1,,,,
7038,0,1,1,,,,
17833,0,4,4,,,,
12893,0,5,5,,,,
7017,0,1,1,,,,
3011,0,1,1,,,,
17519,0,2,2,,,,
8084,0,2,2,,,,
3329,0,2,2,,,,
17849,0,3,3,,,,
17821,0,2,2,,,,
6729,0,2,2,,,,
16888,0,1,1,,,,
8762,0,2,2,,,,
248,0,1,1,,,,
11091,0,1,1,,,,
5642,0,2,2,,,,
15986,0,3,3,,,,
10143,0,2,2,,,,
17319,0,3,3,,,,
4084,0,3,3,,,,
12737,0,2,2,,,,
16527,0,2,2,,,,
13924,0,1,1,,,,
10319,0,1,1,,,,
9749,0,1,1,,,,
8836,0,2,2,,,,
10575,0,2,2,,,,
8408,0,3,3,,,,
8648,0,2,2,,,,
12222,0,1,1,,,,
16828,0,2,2,,,,
6127,0,2,2,,,,
15586,0,1,1,,,,
219,0,2,2,,,,
13008,0,1,1,,,,
10736,0,2,2,,,,
13307,0,1,1,,,,
14079,0,2,2,,,,
13859,0,1,1,,,,
2009,0,1,1,,,,
15953,0,1,1,,,,
14754,0,1,1,,,,
8868,0,1,1,,,,
17575,0,1,1,,,,
8804,0,1,1,,,,
15009,0,2,2,,,,
16469,0,1,1,,,,
11288,0,1,1,,,,
3797,0,1,1,,,,
16494,0,1,1,,,,
6902,0,1,1,,,,
6906,0,1,1,,,,
13327,0,1,1,,,,
9378,0,1,1,,,,
14486,0,1,1,,,,
4645,0,1,1,,,,
17607,0,2,2,,,,
17836,0,2,2,,,,
12223,0,1,1,,,,
15931,0,1,1,,,,
12123,0,1,1,,,,
17786,0,2,2,,,,
10733,0,1,1,,,,
16376,0,1,1,,,,
13295,0,1,1,,,,
7152,0,2,2,,,,
4395,0,1,1,,,,
7439,0,1,1,,,,
10745,0,3,3,,,,
12043,0,3,3,,,,
11466,0,1,1,,,,
10153,0,1,1,,,,
17727,0,2,2,,,,
11576,0,1,1,,,,
5719,0,2,2,,,,
14088,0,1,1,,,,
17214,0,1,1,,,,
13389,0,1,1,,,,
2048,0,1,1,,,,
17907,0,1,1,,,,
15578,0,1,1,,,,
4886,0,2,2,,,,
13317,0,1,1,,,,
17799,0,2,2,,,,
5586,0,1,1,,,,
17295,0,1,1,,,,
15457,0,2,2,,,,
4888,0,1,1,,,,
5793,0,1,1,,,,
17395,0,1,1,,,,
11606,0,1,1,,,,
17812,0,2,2,,,,
16805,0,1,1,,,,
5581,0,1,1,,,,
14239,0,2,2,,,,
13368,0,1,1,,,,
10379,0,1,1,,,,
2818,0,1,1,,,,
5739,0,1,1,,,,
10157,0,1,1,,,,
10569,0,1,1,,,,
16718,0,1,1,,,,
13853,0,1,1,,,,
17903,0,1,1,,,,
11364,0,1,1,,,,
17008,0,1,1,,,,
12119,0,2,2,,,,
16370,0,1,1,,,,
8501,0,1,1,,,,
16246,0,1,1,,,,
13654,0,1,1,,,,
12865,0,1,1,,,,
9516,0,1,1,,,,
17633,0,1,1,,,,
11006,0,1,1,,,,
17356,0,1,1,,,,
17391,0,1,1,,,,
1486,0,1,1,,,,
17533,0,1,1,,,,
12163,0,2,2,,,,
9922,0,1,1,,,,
9066,0,1,1,,,,
11229,0,1,1,,,,
11424,0,1,1,,,,
10120,0,1,1,,,,
7742,0,1,1,,,,
5866,0,1,1,,,,
,,,,,,,
,570,756,784,,,,
